AaminaBintiWahb=Aamina 宾萨义词对词
Abbasid=阿拔斯王朝字
AbdullahBinAbbas=阿卜杜拉 · 本 · 阿巴斯字
AbdullahBinAbduAlMuttalib=阿卜杜拉 · 本 · 阿卜杜 Al Muttalib 字
AbdullahBinAlZubayr=阿卜杜拉 · 本 · 基地祖拜尔字
AbdullahBinAmrBinAlAas=阿卜杜拉 Bin Amr Bin Al 原子吸收光谱字
AbdullahBinMasood=阿卜杜拉 · 本 · 马苏德字对字的
AbdullahBinMuhammad=阿卜杜拉 · 本 · 穆罕默德 · 字
AbdullahBinUmar=阿卜杜拉 · 本 · 欧麦尔字
Abdullah=阿卜杜拉字
AbdurRahmanBinAwf=阿卜杜勒 Rahman Bin 接替字
AbidingTherein=遵循其中字
AbooDarda=比达尔达字
AbooMoosaaAlAsharee=比窥见 Al Asharee 字
AbooZayd=比 Zayd 字
AbrogatingAndAbrogatedVerses=废除和废止的诗歌词对词
AbsoluteIdentical=绝对相同字一个字
AbsolutePredestination=绝对的缘分字
AbsoluteProximate=绝对的近似逐字逐句
AbsoluteSimilar=绝对的类似逐字逐句
AbuBakrAlSaddiqAbdullahBinAbiQuhafah=阿布 · 贝克尔 · 阿尔萨迪克阿卜杜拉 Bin Abi Quhafah 字
AbuDahr=阿布代赫尔字
AbuHurairah=孝顺字
AbuJahl=阿布哲字
AbuLahab=Abu Lahab 字
AbuSufyan=阿布扬字
AbuTalib=Abu Talib 字
AbuUbaidahBinAlJarrah=Abu Ubaidah Bin 阿尔杰字对字的
Abyss=词对词的深渊
AcaciaTree=相思树字
AccountReckoningQuestioning=帐户的清算质疑字
AccusativeNounIndicatingPlaceWhereActionOccurs=行动发生词对词的宾格的名词指示地方
AccusativeNounIndicatingTimeWhenActionOccurs=行动发生时词对词的宾格的名词表示时间
AccusativeParticles=宾格粒子字
ActiveParticipleVerbalDoer=主动分词口头实干家字
AfterBuryingTheDeceased1=后埋 Deceased1 字
AfterCallToPrayerFirstPart=O 真主|耶和华|这|呼叫|完成|和祈祷|我们的
AfterCallToPrayerSecondPart=给|穆罕默德|他的代祷的权利|和美德
AfterCallToPrayerThirdPart=和提高他|排名|高架|其中|你已答应他
AfterLeavingTheToilet1=我寻求你的宽恕
AfterMigrationSymbol=后迁移符号字
AfterMigration=后迁移字
AfterRainfall1=Rainfall1 字后
AishaBintAbiBakr=阿伊莎 · 宾特 · 艾布拜克尔字
AlAbbasBinAbduAlMuttalib=阿尔-阿巴斯 · 本 · 阿卜杜 Al Muttalib 字
AlAwzaai=Al Awzaai 字
AlefMaksura=Alef Maksura 字
AlefWasla=Alef Wasla 字
AlefWithHamzaAbove=Alef 随以上字一个字喉塞音符
AlefWithHamzaBelow=Alef 随以下字一个字喉塞音符
AlefWithMaddaAbove=Alef 随以上字一个字 Madda
Algeria=阿尔及利亚字
AliBinAbiTalib=阿里 Bin Abi Talib 字
AliBinHussein=阿里 · 本 · 侯赛因字
AliBinMuhammad=阿里 · 宾 · 穆罕默德字
AliBinMusa=阿里 · 本 · 穆萨字
AlIstibsar=Al Istibsar 字
AllahHaveMercyOnBothOfThem=真主怜悯他们字对字的两个
AllahHaveMercyOnHer=真主怜悯她字
AllahHaveMercyOnHim=真主怜悯他字
AllahHaveMercyOnThemFeminine=真主怜悯他们女性词的词
AllahHaveMercyOnThemMasculine=真主怜悯他们男性词对词
AllahIsGreatestAllahIsGreatest=真主是伟大真主是伟大的字
AllahIsGreatest=真主是伟大的字
AllahKnowsBest=真主知道最好的字
AllahLightHeavensAndEarth=安拉光天地字
AllahProtectionAndHelp=安拉保护和帮助字
AllahProtection=安拉保护字
AllahSaysTheTruth=真主说字对字的真相
AllahSufficesMe=安拉就够我字
AllahWilledItSo=真主的旨意所以字
AllahWilling=真主愿意字
Allah=安拉字
AlLaythBinSaad=基地很有意思 · 萨德 · 字
AllowedSeparatedLengthening=允许分离延长字
AllPraiseAndThanksBeToAllahLordOfTheWorlds=所有的赞美和感谢将给世界字对字的真主魔王
AllPraiseAndThanksBeToAllah=所有的赞美和感谢全归真主字
AllRightsReserved=所有权利保留字的
AlMansoor=阿尔曼苏尔字
AlMuwata=Al Muwata 字
AlOfDefiniteness=Al 的确定性字
AlSunanAlSughra=Al 苏南基地岛字一个字
AlWahsi=Al Wahsi 字
AmaarBinYaasir=奥宾亚字
AmrBinAlAas=Amr Bin Al 原子吸收光谱法字
AnasBinMaalik=阿纳斯 · 本 · 马利克字
AndAllahHasTheBestNamesCallUponHimAndLeaveThemInPlaceThoseNamesNotablyCutOffWhatTheyDo=真主具有最佳名称呼吁他和那些名字特别是切断他们把他们留在地方做字
AndAllahHasTheBestNamesSoCallOnThemLeaveThoseWhoPracticeDeviationConcerningHisNamesTheyWillBeRecompensedForWhatTheyHaveBeenDoing=真主有最好的名字，因此，呼吁他们离开那些实践偏差关于他的名字，他们将会得到回报什么他们做字一个字
AndAllahHasTheBestNamesSoCallOnThem=真主具有最佳的名字所以呼吁他们词对词
AndBreaksFast=和符快字
AndForParentsKindness=父母的好意字
AndHePlacedBetweenYouAffectionAndMercy=他放在你的感情和怜悯字之间
AndOfHisSignsIsThatHeCreatedForYouFromYourselvesMatesThatYouMayFindTranquillityInThem=他的标志是他从自己的伴侣，你可能会找到安宁在他们字对字的创建为您
AndPrepareAgainstThemWhateverYouAreAbleOfPower=并准备对他们无论你是能的字对字的力量
AndUponYouBePeaceAndMercyOfAllahAndBlessings=在你身上是和平与慈悲的真主和祝福词对词
AndUponYouBePeaceAndMercyOfAllah=在你身上是和平与慈悲的真主字
AndUponYouBePeace=在你身上得到和平字
Antichrist=反基督者字
ArabicDictionary=阿拉伯语词典词对词
Ashura=阿舒拉节字
Askaree=Askaree 字
AskingForClearSkies1=要求明确 Skies1 字
AssimilateGreatIdentical=吸收大相同字
AssimilateLaamSunLetter=同化 Laam 太阳字母词的词
AssimilateSmallIdentical=同化小相同字一个字
AssimilateSmallProximate=同化小近字一个字
AssimilateSmallSimilar=同化小类似字一个字
Astray=字迷了路
AttachedPronouns=连接的代词字
AtTheStartOfPrayer1=O 真主，|分离|我|从|我的罪|作为|你已经分居||东方|从西方国家。|O 真主，|洁净我|在|我的过犯|作为|洁净|服装|白色|在|污渍。|O 真主，|洗|离开|我的罪|加冰|和水|和霜冻。
AtTheStartOfPrayer2=荣耀是给你，|O 真主，|和赞美，|是有福的|姓名|和崇高|是陛下，|没有|值得一的崇拜|但你。
AtTheStartOfPrayer3=我转|我的脸|对一个人|创建时间|诸天|和地球，|作为一个忠实的信徒。|非|我是|那些|谁将关联以物配主的伙伴。|实在，|我的祈祷|和我的热情，|我的生活|和我的死亡，|是为真主，|耶和华|世界，|否|合作伙伴|有他。|因此|我已吩咐|和我|其中谁|已提交。|O 真主，|您|是国王，|没有|值得一的崇拜|but|你。|您|是我的主|和我|你的奴隶。|我冤枉了|我自己的灵魂|承认|我的罪孽。|原谅|我为|我的罪|所有的|肯定|none|原谅|罪|but|你。|引导我|对完善|我的角色，|没有一个|指南|对及其完善|but|你。|保护|我从|邪恶的我的性格，|没有一个|可保护|我从|其罪恶|but|你。|我在这里|在您的服务。|善良|all|在你的手，|与邪恶|不归因于|给你。|I|上午由您 (创建)|和我我给你 (返回)。|你是最幸福的|最尊贵。|我寻求你的宽恕|并要悔改行|给你。
AtTheStartOfPrayer4=O 真主，|耶和华|Jibra'il，|Mika'il|和 Israfil。|制造商|诸天|和地球。|知者的|看不见的|与所见。|您|法官|介于|你的奴隶|那|关于|在其中|他们不同。|引导我|对那|还有的区别关于|在其中|从|真相，|由你的离开。|当然，|你的指南||你请谁|到|直道|路径。
AtTheStartOfPrayer5=真主|是最了不起的|最伟大。|真主|是最了不起的|最伟大。|真主|是最了不起的|最伟大。|表扬|是向安拉，|丰富。|表扬|是向安拉，|丰富。|表扬|是向安拉，|丰富。|荣耀|是向安拉，|在破碎的一天|和在它的末端。|(3) x|我寻求庇护|在安拉|从|撒旦，|开始时间|他的呼吸|从他的声音|从他的耳语。
AtTheStartOfPrayer6=O 真主，|对你来说是|赞美。|您|是的光|诸天的国|和地球|和这一切|它们包含。|对你来说是|赞美，|您|是维系者|诸天的国|和地球|和所有|它们包含。|(对你而言是|赞美，|您|是耶和华|诸天的国|和地球|和所有|他们包含)。|(对你而言是|赞美，|您的变更|是统治|诸天的国|和地球|和所有|他们包含)。|(对你而言是|赞美，|您|是王|诸天的国|和地球)。|(和你是|赞美)。|(你|都是实话，|你的诺言|是真实的|你的话语|是真实的|你的听众|是真实的|天堂|是真实的|地狱|是真实的|先知|是真实的|和穆罕默德 (愿主)|是真实的|小时的判断|是真的)。|(O 真主，|给你|我已经提交，|和在你身上|我信赖。|在你|我一直相信|和你|我把在悔过。|为你的缘故|我争议|以你的标准|我判断。|原谅|我|什么|我把在我面前|和什么|我在我身后，让|什么|我隐瞒|和什么|我宣布。)|(你|有一个人发出|和你|一位延迟|没有|谁有权来敬拜|but|你的)。|(你|是我的神，|没有|谁有权来敬拜|but|你的)。
Attributes=属性词对词
Audible=词对词的声音
AzZubayrbinAlAwam=Az Zubayrbin Al 坦字
Baaqir=Baaqir 字
BaniHashim=巴尼 Hashim 字
BaniMakhzoom=巴尼 Makhzoom 字
BaniThaqeef=巴尼 Thaqeef 字
BasisOfTransmissionOfLanguage=传播的语言词对词的基础
Bed=床上字
BeforeEating2=前 Eating2 字
BeforeEating3=前 Eating3 字
BeforeEating4=前 Eating4 字
BeforeEnteringTheToilet1=(然后)O 真主|I|寻求保护|在你|从|男性的邪魔|和女性的邪魔
BeforeGivingPeaceOfPrayer10=之前给 Prayer10 字对字的和平
BeforeGivingPeaceOfPrayer11=之前给 Prayer11 字对字的和平
BeforeGivingPeaceOfPrayer1=之前给 Prayer1 字对字的和平
BeforeGivingPeaceOfPrayer2=之前给 Prayer2 字对字的和平
BeforeGivingPeaceOfPrayer3=之前给 Prayer3 字对字的和平
BeforeGivingPeaceOfPrayer4=之前给 Prayer4 字对字的和平
BeforeGivingPeaceOfPrayer5=之前给 Prayer5 字对字的和平
BeforeGivingPeaceOfPrayer6=之前给 Prayer6 字对字的和平
BeforeGivingPeaceOfPrayer7=之前给 Prayer7 字对字的和平
BeforeGivingPeaceOfPrayer8=之前给 Prayer8 字对字的和平
BeforeGivingPeaceOfPrayer9=之前给 Prayer9 字对字的和平
BeforeSexualIntercourse1=前性 Intercourse1 字
BeforeTravel=我特此离开你|真主确|与这种宗教|和什么|职责|和以前|契据
BetweenTwoProstrations1=两个 Prostrations1 字之间
BetweenTwoProstrations2=两个 Prostrations2 字之间
BeWithAllah=是以物配主词的词
BirthdayOfTheProphet=字对字的先知的生日
BitterObnoxiousThornyPlant=苦味道令人讨厌的棘手植物词对词
BlazingFlame=熊熊火焰字
BlessedAndExaltedBeHe=祝福和崇高被他字
BlessedFeastCelebration=福的宴庆祝词对词
BlessedMecca=有福的麦加字
BlessingsOfAllahUponBothOfThem=真主的祝福他们字对字的两个
BlessingsOfAllahUponHer=真主的祝福她字
BlessingsOfAllahUponHim=真主的祝福他字
BlessingsOfAllahUponThemFeminine=真主的祝福词对词的女性
BlessingsOfAllahUponThemMasculine=真主的祝福阳性词对词
BlessingsOfAllah=真主字对字的祝福
BoilingOil=沸油字
BoilingWater=沸腾的水字
BridleIt=缰绳字
BrokenPlural=破碎的复数词对词
BrokenToPieces=碎了词的词
CallToBeginPrayerSixthVerse=事实上|已开始|祷告
CallToPrayerEighthVerse=有没有|神|除了|真主
CallToPrayerFifthVerse=来吧|到|成功
CallToPrayerFourthVerse=来吧|到|祷告
CallToPrayerSecondVerse=我作证|那|有没有|神|除了|真主
CallToPrayerSeventhVerse=真主是|最大
CallToPrayerSixthVerse=祷告是|更好|于|睡眠
CallToPrayerThirdVerse=我作证|那|穆罕默德是|信使|真主
CaveOfHira=Hira 词对词的洞穴
Celebration1=Celebration1 字
Celebration2=Celebration2 字
CentralTreasury=中央财政部字
CharacterDoubled=增加了一倍字对字的字符
ChestInterior=胸部内政字
China=中国字
ClassicArabic=经典阿拉伯语词对词
ClearLaamMoonLetter=清除 Laam 月亮信字
Closing=关闭字
Cohabitation=同居字
CollectiveObligation=词对词的集体义务
Colon=结肠字
ComeToPrayer=祷告词对词的来到
ComeToSuccess=来到成功字
CommandTenseVerb=命令紧张动词词对词
CommentaryByContemplation=沉思字对字的评论音轨
ComparativeDerivedNoun=比较派生名词字
ConditionDenotedByConditionParticle=由条件粒子字表示的条件
ConditionOfOath=宣誓词对词的条件
Condolence1=Condolence1 字
ConnectedLengtheningEssential=连接延长基本词对词
ConnectedPronoun=连接的代词字
ConnectingParticles=连接词对词的粒子
ConsensusOfThePeopleOfMedina=梅迪纳字对字的人的共识
ContradictoryDifferences=矛盾差异字
Cover=盖字
CreedOfIslamFirstPart=伊斯兰教第一部分词对词的信条
CreedOfIslamSecondPart=伊斯兰教第二部分词对词的信条
CreedOfIslam=信仰伊斯兰教字
DailyPredestination=每日缘分字
Dammatan=Dammatan 字
DayOfWeek1=Week1 字对字的一天
DayOfWeek2=Week2 字对字的一天
DayOfWeek3=Week3 字对字的一天
DayOfWeek4=Week4 字对字的一天
DayOfWeek5=Week5 字对字的一天
DayOfWeek6=Week6 字对字的一天
DayOfWeek7=Week7 字对字的一天
DeclarationWhenSittingInPrayer1=申报书时坐在 Prayer1 字
DeductionByResemblance=由相似词对词的扣除
Definiteness=确定性字
Definite=确切的消息，由词
DeputyDoer=副实干家字
DerivedIntensiveAdjectivesIntransitive=派生的密集形容词迷字
DerivedNouns=派生的名词字
DerivedSuperlativeAdjectivesTransitive=派生的比较级形容词动词词对词
DescribingConstruction=描述建设字
DesperateOddPrayer1=绝望的奇数 Prayer1 字
DesperateOddPrayer2=绝望的奇数 Prayer2 字
DesperateOddPrayer3=绝望的奇数 Prayer3 字
DetachedPronouns=超然的代词字
DetachedPronoun=超然的代词字
Diffusion=扩散字
DirectObjectOfVerb=直接宾语的动词词对词
DisbeliefOfActs=不相信的字对字的行为
DisbeliefOfHeart=不相信的心字
DisbelievingPeople=怀疑人字
Discord=不字对字的和谐
DisjointedLetters=脱节的字母词的词
Distanced=远距离的字一个字
DistinctionLengthening=区分延长字
Divinity=神字
DivorcedWomen=离婚的妇女字
DoctrineOfUnityOfExistence=统一的词对词的存在学说
DoctrineTheologyPrincipleOfBelief=字对字的信仰主义神学原则
Dragging=拖字
Dusk=黄昏词对词
Ease=易用性词的词
Eighth=第八字
Elevation=高程字
Elisha=以利沙字
Elongation=断裂伸长率字
Embarass=Embarass 字
Emigrants=移民字
Emirates=阿联酋字
EmptyHamza=空喉塞音符词对词
EnlightenedMedina=开明的麦地那字
EnteringMasjidilHaram=O 真主|祢|和平|和从你|和平|导致我们生活|我们的主|与和平|导致我们进入|天堂|这房子|和平|所有者的荣誉|我们的主|和陛下|祢|最幸福|和崇高|O 真主|格兰特|我|带有|你的祝福|和宽恕|和我住|在它|量的名称|真主|和所有的称赞是到|真主|salawat|和萨拉姆|到我们|信使|真主|称呼|真主|在他身上|与和平
EnteringMosque=进入清真寺字
EnterItWithPeaceAndSafety=输入与和平与安全词对词
EssenceOfTheBook=字对字的这本书的精华
EssentiallyPossessiveConstruction=本质上是占有欲建设字
EstablishCharity=建立慈善字
EstablishPrayer=建立祷告词对词
Ethics=伦理字
ExcellenceOfRemembranceAndGlorificationOfAllah10=卓越的纪念和歌颂 Allah10 字
ExcellenceOfRemembranceAndGlorificationOfAllah11=卓越的纪念和歌颂 Allah11 字
ExcellenceOfRemembranceAndGlorificationOfAllah12=卓越的纪念和歌颂 Allah12 字
ExcellenceOfRemembranceAndGlorificationOfAllah13=卓越的纪念和歌颂 Allah13 字
ExcellenceOfRemembranceAndGlorificationOfAllah14=卓越的纪念和歌颂 Allah14 字
ExcellenceOfRemembranceAndGlorificationOfAllah1=卓越的纪念和歌颂 Allah1 字
ExcellenceOfRemembranceAndGlorificationOfAllah2=卓越的纪念和歌颂 Allah2 字
ExcellenceOfRemembranceAndGlorificationOfAllah5=卓越的纪念和歌颂 Allah5 字
ExcellenceOfRemembranceAndGlorificationOfAllah6=卓越的纪念和歌颂 Allah6 字
ExcellenceOfRemembranceAndGlorificationOfAllah8=卓越的纪念和歌颂 Allah8 字
ExcellenceOfRemembranceAndGlorificationOfAllah9=卓越的纪念和歌颂 Allah9 字
ExchangeLengthening=交换延长字
ExclamationMark=感叹号字
Ezekiel=以西结书字
FairLadiesOfTheRiver=公平的女士们的字对字的河
FamiliarOpinionBasedExegesis=熟悉的意见以训诂词对词
FarPointingNouns=远指词对词名词
FarthestMosque=最远清真寺字
Far=远字
FastBreakingCharity=很快，结果打破慈善字
Fathatan=Fathatan 字
FatimaBintiAmr=法蒂玛 · 宾 Amr 字
FatimaBintiMuhammad=法蒂玛 · 宾穆罕默德字
Fatimid=法蒂玛王朝字
FearAllah=你们当敬畏真主字
Feminine=女性词的词
FestivalOfBreakingFast=节日的打破快字
FestivalOfSacrifice=献祭词对词的节日
FifthCreed=我寻求宽恕|从真主|我的主|从|每隔|sin|我犯了|知情的情况下|或者|unknowningly|偷偷地|或者|公开|和我转向|他|从|罪|那|我知道|和从|罪|那|非|我知道|当然|你是|知者|隐藏的东西|和遮瑕膏|所犯的错误|和宽恕|罪得赦免|和没有|might|和没有|强度|除了|以物配主|最高|最壮丽
Final1=其中|非|他是这样的|东西|他是|听话人|先见
Final2=O 真主|发送|最好的|祷告|upon|最佳|你们的创造物|母版|默罕默德
Final3=与和平|诉说着|他的知识|和油墨|他话里的|每当|记得他|这样做|当那些人忽视|到|记得他|这样做
FireInferno=地狱火字
FirstCreed=有没有|神|除了|真主|默罕默德|信使|真主
FirstFamilyRootVerb=第一家庭根动词词对词
FirstPersonAttachedPronoun=第一人称附加词对词代词
FirstPersonSingularVerbalAttachedPronoun=第一人称单数语言附加词对词代词
FiveSpecialNouns=五个特殊名词字
FixedInTheBookAndTradition=在这本书和传统字对字的固定
Fluency=流利的字
FollowerOfFollowers=追随者字对字的追随者
ForAnxietyAndSorrow1=焦虑和 Sorrow1 字
ForAnxietyAndSorrow2=O 真主，||我寻求庇护|在你|从|悲伤|和悲伤，|从弱点|和从懒惰，|从吝啬|和从懦弱，|从被克服|由债务|和制服|男人们 (即其他人)。
ForbiddanceOfAscribingThingsToOmens1=锁止的把事情归咎于 Omens1 字
ForbiddenUponYouTheDeadAnimal=禁止在你身上死动物词的词
ForConcludingAllSittings1=为结束所有 Sittings1 字
ForExpiationOfSinsAtTheConclusionOfSittingOrGathering1=荣耀是给你|O 真主|和好评|我可以作证|那|没有|值得一的崇拜|but|您|我寻求你的宽恕|和悔改的|给你
ForExpiationOfSinsAtTheConclusionOfSittingOrGathering2=为在结束时，或坐或 Gathering2 词对词的罪赎罪
ForFearOfShirk1=由于 Shirk1 字对字的担心
FormlessMetaphor=无形的隐喻词对词
ForOneAfflictedWithDoubtInFaith2=一个患 Faith2 字对字的怀疑
ForOneInDistress1=一 Distress1 字
ForOneInDistress2=一 Distress2 字
ForOneInDistress4=一 Distress4 字
ForOneWhoseAffairsHaveBecomeDifficult1=对于一个其事务已成为 Difficult1 字对字的
ForRain1=为 Rain1 字
ForRain2=为 Rain2 字
ForRain3=为 Rain3 字
ForSeekingGuidance1=为寻求 Guidance1 字
ForTheAdvancementOfRewardDuringTheFuneralPrayer1=为奖励在葬礼 Prayer1 字对字的地位
ForTheDeceasedAtFuneralPrayer1=为在葬礼 Prayer1 字对字的死者
ForTheDeceasedAtFuneralPrayer2=为在葬礼 Prayer2 字对字的死者
ForTheDeceasedAtFuneralPrayer3=为在葬礼 Prayer3 字对字的死者
ForTheDeceasedAtFuneralPrayer4=为在葬礼 Prayer4 字对字的死者
ForTheOneYouHaveInsulted1=对于一个你有 Insulted1 字
ForTravel1=为 Travel1 字
FoulNourishmentPusDischarge=犯规营养脓放电字
FourLetterRootVerb=四个字母的动词词根词对词
FourthCreed=有没有|神|除了|真主|孤独|否|合作伙伴|有他|对他来说|联合王国|和他|表扬|他给生活|和带来的死亡|他是|过生活|非|有能力的死亡|从不|曾经|占有人|威严的|与崇敬|在他的手|善良|他是|upon|全部|事情|功能强大
FundamentalPrinciplesOfQuranicInterpretation=古兰经 》 解释词对词的基本原则
GateOfCharity=门的慈善字
GateOfFaith=词对词的信仰之门
GateOfFasting=门的空腹字
GateOfJihad=字对字的圣战之门
GateOfPilgrimage=门的朝圣字
GateOfPrayer=祷告词对词的大门
GateOfRemembrance=纪念词对词的大门
GateOfRighteousnessToParents=门的义词对词的父母
GateOfWithholdingAngerAndForgivness=门的扣缴愤怒和词对词的原谅
Gathering=收集字
Gender=性别字
GenericNounInPossessiveConstructionWithDefiniteNounOrPronoun=通用名词所有格建设与明确的名词或代词字
GloriousAllahWilling=光荣的真主愿意字
GloriousAndExaltedBeHe=光荣和崇高，必字
GloryBeToAllah=荣耀归于真主字
GloryBeToYouAllah=荣耀归于真主字
GogAndMagog=歌革和玛各词的词
GrandWord=大词字
GreatBounce=大反弹字
GreatProximate=伟大的近似词的词
GreatSimilar=伟大的类似逐字逐句
GreatWithPraiseToAllah=伟大真主字对字的颂赞
GroomOnWeddingNightOrWhenBuyingAnimal1=在新婚之夜新郎或当购买 Animal1 词的词
Group=组字
HadithQudsi=库德西圣训字
HadithSciences=圣训科学字
Hadi=哈迪字
HafsaBintUmar=欧麦尔兹 · 宾特 · 字
HamzaBinAbduAlMuttalib=哈姆扎 · 本 · 阿卜杜 Al Muttalib 字
HappyFeastCelebration=幸福快乐的元宵节庆祝词对词
HarmOfTheEye=词的词眼的危害
HasanAskariBinAli=哈桑阿斯卡里本 · 阿里字
HasanBinAli=哈桑 · 本 · 阿里字
Hasan=哈桑字
HeartSofteners=纯洁性字
Heaven=天堂词对词
HeIsAllah=他是真主字
HiddenMetaphor=隐藏的隐喻词对词
HigherVerbFamiliesDerivedFromFirstFamily=较高的动词家庭来自第一家庭字
HindBintAbiUmayya=Abi 倭马亚后腿 · 宾特 · 字
HolyHouse=圣洁的房子字
HorribleTreeOfHell=可怕的地狱字对字的树
HotFoodGreaseSweat=热的食物润滑脂汗字
HowTheProphetMadeTasbeeh1=如何先知作 Tasbeeh1 字
Hudabiyyah=Hudabiyyah 字
HusseinBinAli=侯赛因 · 本 · 阿里字
Hussein=侯赛因字
IAskAllahForgiveness=我请求真主宽恕字
IHavePutTrustInAllah=我倚靠在安拉字
IhramPrayerSupplication=量的名称|真主|最亲切|最仁慈|真主|是最大的|真主|是最大的|真主|是最大的|如何完美|他是|一位已放置|这 (运输)|而不是|我们自己|，|本来能够|和真正|到|我们的主|是我们最后的命运|O 真主|真正|我们对你的要求|in|旅行|此|比尔|和 taqwaa|和|事迹|其中|请你|O 真主|帮助|便利|我们的旅程|此|让我们覆盖它的距离|真正|快速|O 真主|你是|同伴|打开|旅程|及后继者|越过|家庭|O 真主|I|带你的避难所|从|困难|传播|和有变化的心|在一个糟糕的困境|和出来|很倒霉|带有|财富|和家人
ImamAbuHanifa=伊玛目艾布哈尼法字
ImamAlLayth=伊玛目 Al Layth 字
ImamAthThawri=伊玛目 Ath 扫蕾字
ImamAtTabari=伊玛目在泰伯字
ImamAwzaee=伊玛目 Awzaee 字
ImamBukhari=伊曼字
ImamDawood=达乌德 • 伊玛目字
ImamHanbal=伊玛目罕字
ImamMalik=伊玛目马利克字
ImamMuhammadTaqi=伊玛目穆罕默德 Taqi 字
ImamMuslim=伊玛目穆斯林字
ImamNawawi40Hadith=伊玛目 Nawawi40 圣训字
ImamShafiee=伊玛目 Shafiee 字
ImamZayd=伊玛目宰字
ImmediatelyFollowingDeclarationOfFaithInCallToPrayer1=I|见证|那|none|有权受崇拜|but|真主|独自一人，|否|合作伙伴|有他，|和那|默罕默德|是他的奴隶|和他的使者。|我很高兴|以物配主|作为我的主，|与默罕默德|作为我的信使|和伊斯兰教的教义|作为我的信仰。
InBetweenRecitation=在朗诵词对词
InclinationDrifting=倾角漂流字
IndefiniteInNegativeOrProhibitiveConstruction=在消极或禁止建设字对字的无限期
India=印度字
IndicationOfMeaningByNecessarySupposition=通过必要的假设词对词的意义的征兆
IndicationOfMeaningBySuggestion=由建议词对词的意义的征兆
IndirectObject=间接宾语字
IndividualObligation=个人义务字
InProtectionOfAllah=在安拉词对词的保护
InRemembranceOfAllahHeartsFindPeace=在纪念安拉的心找到和平字
InShort=总之字
InstructionForOneAfflictedByCalamity1=一个受 Calamity1 字对字的指令
InstrumentOfAction=行动词对词的手段
IntenselyHotWind=炽热的风字
IntentionForIhramPrayer=我提供|建议|受戒祷告|两个专用|真主确|最高
IntentionForIhramShower=我打算|洗澡|建议|受戒淋浴|真主确|最高
IntentionForJourneyPrayer=我提供|建议|萨法尔 · 祈祷|两个专用|真主确|最高
IntentionForJourneyShower=我打算|洗澡|Musafir 淋浴|建议|真主确|最高
IntentionToPerformUmrah=我打算|副朝|和受戒|只是|真主确|最高
Intercession=代祷词对词
InterestFreeLoan=免息贷款字
InTheEvening1=我们已经结束了新的一天|和与它|所有的统治|是真主的。|表扬|是对阿拉。|无|有权受崇拜|but|真主|独自一人，|否|合作伙伴|有他。|向安拉|国权，|对他|是赞美|他是|upon|全部|事情|能做到。|我的主，|我问你|美好的事物||在|此|夜晚|并且|来的夜晚|在它之后，|我寻求庇护|在你|从|邪恶||在|此|夜晚|并且|来的夜晚|在它以后。|我的主，|我寻求庇护|在你|从|懒惰|和无助|年老了。|我的主，|我寻求庇护|在你|从|处罚|在|地狱之火，|和从处罚|在|坟墓。
InTheEvening2=O 真主，|您|给我们带来年底的一天|作为你|给我们带来它的起点，|您|带给我们的生活|和你|给我们带来死亡，|和你|是我们的命运。
InTheEvening3=O 真主，||我有另一天结束|并呼吁你|和后|承担者|你的宝座，|在你的天使|和所有|创作|为见证，肯定|您|是真主，|没有|值得一的崇拜|but|您|独自一人，|否|合作伙伴|你有，|和那|默罕默德|是你的奴隶|和你的信使。
InTheEvening4=O 真主，|作为|我进入这个晚上||无论|祝福一直以来深受我|或者|任何人|在|你的创造|是从你|独自一人，|否|合作伙伴|你有。|给你的|一切赞颂|和你|是表示感谢。
InTheEvening5=我们已经结束了新的一天|和与它|所有统治|其中属于真主，|耶和华|所有的存在。|O 真主，||我问你|美好的事物|这|晚上，|它的胜利，|它的帮助，|它的光芒，|它的祝福，|和它的教导。|我寻求庇护|在你|从|邪恶|那是|在它|和从邪恶|那|跟随它。
InTheEvening6=我们结束这一天|upon|自然宗教|伊斯兰教，||这个词|真诚奉献，||宗教|我们的先知|穆罕默德 (愿主的真主)，|并且|信心|我们的父亲|易卜拉欣。|他是正直 (在敬拜安拉)，|和一位穆斯林。|非|他是|那些|除真主外的其他人崇拜谁。
InTheEvening7=我寻求庇护|换句话说|真主|完美|从|邪恶|什么|他创造了。
InTheEvening8=我们已经今天晚上|并且|主权是所有|阿拉 s。|赞美是|独自一人，安拉|否|合作伙伴|他有，|有没有|神|but|他，|赐给他们|是我们的命运。
InTheEvening9=O 真主!||在晚上，我站起来|带有|你有赐予我的所有的一切都|祝福，|强度，|和保护。|已完成|你的祝福，|(你赐予我)|强度|和你的保护，|in|这种生活|和来世。
InTheMorning1=我们已经进入了新的一天|和与它|所有的统治|是真主的。|表扬|是对阿拉。|无|有权受崇拜|but|真主|独自一人，|否|合作伙伴|有他。|向安拉|国权，|对他|是赞美|他是|upon|全部|事情|能做到。|我的主，|我问你|善良||在|此|日子|并且|来的日子|在它之后，|我寻求庇护|在你|从|邪恶||在|此|日子|并且|来的日子|在它以后。|我的主，|我寻求庇护|在你|从|懒惰|和无助|年老了。|我的主，|我寻求庇护|在你|从|处罚|在|地狱之火，|和从处罚|在|坟墓。
InTheMorning2=O 真主，|由你|我们输入的早晨|和你|我们进入了晚上，|由你|我们的生活|和你|我们死了，|和你|是最后返回。
InTheMorning3=O 真主，||已经进入了一个崭新的早晨|并呼吁你|和后|承担者|你的宝座，|在你的天使|和所有|创作|为见证，肯定|您|是真主，|没有|值得一的崇拜|but|您|独自一人，|否|合作伙伴|你有，|和那|默罕默德|是你的奴隶|和你的信使。
InTheMorning4=O 真主，|作为|我输入今||无论|祝福一直以来深受我|或者|任何人|在|你的创造|是从你|独自一人，|否|合作伙伴|你有。|给你的|一切赞颂|和你|是表示感谢。
InTheMorning5=我们已经进入了新的一天|和与它|所有统治|其中属于真主，|耶和华|所有的存在。|O 真主，||我问你|善良|这|一天，|它的胜利，|它的帮助，|它的光芒，|它的祝福，|和它的教导。|我寻求庇护|在你|从|邪恶|那是|在它|和从邪恶|那|跟随它。
InTheMorning6=我们已经进入了新的一天|upon|自然宗教|伊斯兰教，||这个词|真诚奉献，||宗教|我们的先知|穆罕默德 (愿主的真主)，|并且|信心|我们的父亲|易卜拉欣。|他是正直 (在敬拜安拉)，|和一位穆斯林。|非|他是|那些|除真主外的其他人崇拜谁。
InTheMorning7=荣耀|是对阿拉|赞美是给他，|由众多|他创作的|由快乐，|他|按重量计|他的宝座，|和多大程度上|他的话。
InTheMorning8=我们已经今|并且|主权是所有|阿拉 s。|赞美是|独自一人，安拉|否|合作伙伴|他有，|有没有|神|but|他，|赐给他们|是的回报。
InTheMorning9=O 真主!||清晨，我站起来|带有|你有赐予我的所有的一切都|祝福，|强度，|和保护。|已完成|你的祝福，|(你赐予我)|强度|和你的保护，|in|这种生活|和来世。
InTheMorningOrEvening10=在早上或 Evening10 字
InTheMorningOrEvening11=在早上或 Evening11 字
InTheMorningOrEvening12=在早上或 Evening12 字
InTheMorningOrEvening13=在早上或 Evening13 字
InTheMorningOrEvening3=O 真主，|您|是我的主，|没有|值得一的崇拜|but|你。|你创造了我|和我|你的奴隶。|I|保持|你的约，|和我对你的承诺|只要|我能，|我寻求庇护|在你|从|邪恶|什么|我做了，|我承认|到|你的祝福|在我身上，|我承认|我的罪行。|原谅|我，|对于|没有|谁可以原谅|罪|but|你。
InTheMorningOrEvening4=O 真主，|使我健康|in|我的身体。|O 真主，|保留|对我来说|我的听力。|O 真主，|保留|对我来说|我的视线。|没有|值得一的崇拜|but|你。|(在阿拉伯语背诵三倍)。|O 真主，||我寻求庇护|在你|从|不敢相信|与贫困|我寻求庇护|在你|从|处罚|坟墓。|没有|值得一的崇拜|but|你。
InTheMorningOrEvening6=在早上或 Evening6 字
InTheMorningOrEvening7=在早上或 Evening7 字
InTheMorningOrEvening8=在名称中|真主，|谁|非|会造成伤害。|带有|他的名字|所有内容|in|地球|也不是|in|天哪，|他是|全听，|全知。
InTheMorningOrEvening9=在早上或 Evening9 字
InTheNameOfAllahMostBeneficentMostMerciful=真主最仁慈最仁慈逐字逐句的名义
InTheNameOfAllah=以字对字的真主的名义
InThePathOfAllah=在安拉词对词的路径
IntransitiveVerb=不及物动词词对词
IntroductionBestNames=我们问你|O，|他|安拉是|谁|有没有|神|除了|他
IntroductionFirst=实在|所有的赞美|是为真主，|我们称赞他，|并寻求他的帮助和指导|和他的宽恕;|我们寻求庇护|在安拉|从|邪恶|我们自己|和从|有罪|我们的行动。|凡|指南|真主|然后无|可以误导|他，|凡|安拉误导|可以有没有|参考线|为他。|和我作证|那|有没有|值得崇拜的神|除了|真主|孤独|否|合作伙伴|有他，|和我作证|那|默罕默德|是他的仆人|和信使。
IntroductionSecond=自|继续:|当然|最好的|语音|是这本书|真主|优秀|指南|是指导|穆罕默德的|祈祷|真主|在他身上|与和平。|最邪恶|事件|是宗教的新发明的问题|和每个|新发明的事|是创新|和每个|创新|已偏离|和每个|偏离|在|火。
InvocationAfterDeclarationWhenSittingInPrayer1=当坐在 Prayer1 字对字的声明后调用
InvocationAfterDeclarationWhenSittingInPrayer2=当坐在 Prayer2 字对字的声明后调用
Iraq=伊拉克字
IslamicDisciplines=伊斯兰学科字
IslamicNewYear=伊斯兰新年字
IsraAndMiraj=伊斯拉和 Miraj 字
ISwearByAllah1=我起誓 Allah1 字
ISwearByAllah2=我起誓 Allah2 字
ISwearByAllah3=我起誓 Allah3 字
ISwearByAllah4=我起誓 Allah4 字
JaabirBinAbdullah=贾比尔 · 本 · 阿卜杜拉字
JafarBinAbiTalib=贾法尔 Bin Abi Talib 字
JafarBinMuhammad=贾法 · 本 · 穆罕默德 · 字
Jawaad=Jawaad 字
JesusSonOfMary=玛丽词对词的儿子耶稣
Jordan=Jordan 字
JuwayriyaBintAlHarith=Juwayriya Bint Al 哈里斯字
Kadhim=卡迪姆字
Kasratan=Kasratan 字
KhadijahBintKhuwaylid=赫蒂杰 · 宾特 · Khuwaylid 字
KhalidBinWalid=哈立德 · 本 · 瓦利德字
Khawarij=Khawarij 字
Kinship=亲属词的词
KitabAlKafi=塔布铝卡菲字
Kuwait=科威特字
LaamHeaviness=Laam 沉重字
LaamLightness=Laam 轻盈字
LaamOfEmphasis=Laam 重点词对词
LaamParticle=Laam 粒子字
LaamVerb=Laam 动词词对词
LeftCurlyBracket=左花括号字
LeftPointingDoubleAngleQuotationMark=左指双尖引号字
LeftSquareBracket=字的左方括号
LegalMethodologyFundamentalPrinciplesOfIslamicLaw=法学方法论伊斯兰法律词对词的基本原则
Legislation=立法字
LegislativePrescription=立法处方字
LengtheningPresentedToSukoon=延长提交 Sukoon 字一个字
LifePredestination=生活缘分字
LightenedCompulsoryLengtheningLetters=减轻的义务教育延长字母词的词
LightenedCompulsoryLengtheningWords=减轻的义务教育延长字对字的单词
LightOfTheHeavensAndEarth=天堂和地球词对词的光
LinguisticMetaphorMetonymy=语言隐喻转喻词对词
LiteralExegesis=文字训诂词对词
LoteTree=Lote 树字
LotusTree=莲花树字
Lowering=降低字
LowerSelf=词对词的较低自我
MadeAgainstAnEnemy1=针对 Enemy1 作出字
MajorAssociation=主要关联词的词
MajorIncorrectPronunciation=主要的不正确的发音词对词
MajorPolythiesm=主要多神论词的词
Mankind=人类字
ManLaYahduruhuAlFaqih=人 La Yahduruhu Al 法基字
MannersOfDiffering=不同词对词的举止
Manners=词对词的举止
MariaAlQibtiyya=玛丽亚 Al Qibtiyya 字
Masculine=男性词对词
MayAllahAcceptFromUsAndFromYou=可能安拉接受来自我们和您字对字的吗
MayAllahAcceptYourEffort=安拉可能接受你的努力字对字的吗
MayAllahBePleasedWithBothOfThem=愿安拉喜悦他们字对字的两个吗
MayAllahBePleasedWithHer=愿安拉喜悦她字对字的吗
MayAllahBePleasedWithHim=愿安拉喜悦他字对字的吗
MayAllahBePleasedWithThemFeminine=愿安拉喜悦他们女性词的词
MayAllahBePleasedWithThemMasculine=愿安拉喜悦他们男性词对词
MayAllahBlessYou=愿真主保佑你字对字的吗
MayAllahContinuouslyShowerBlessingsUponBothOfThem=安拉可能不断沐浴着两人词对词的祝福吗
MayAllahContinuouslyShowerBlessingsUponHer=安拉可能不断沐浴着她逐字逐句的祝福吗
MayAllahContinuouslyShowerBlessingsUponHim=安拉可能不断沐浴着他逐字逐句的祝福吗
MayAllahContinuouslyShowerBlessingsUponThemFeminine=可能真主不断的祝福在他们身上女性词对词吗
MayAllahContinuouslyShowerBlessingsUponThemMasculine=可能真主不断的祝福在他们身上男性词对词吗
MayAllahHaveMercyOnBothOfThem=愿真主慈悯上两人词的词吗
MayAllahHaveMercyOnHer=愿真主慈悯她字对字的吗
MayAllahHaveMercyOnHim=愿真主慈悯他字对字的吗
MayAllahHaveMercyOnThemFeminine=愿真主慈悯他们女性词对词吗
MayAllahHaveMercyOnThemMasculine=愿真主慈悯他们男性词对词吗
MayAllahKeepBothOfThemWell=愿安拉使他们两个字好吗
MayAllahKeepHerWell=愿安拉使她好字吗
MayAllahKeepHimWell=愿安拉使他好字吗
MayAllahKeepThemFeminineWell=愿安拉使他们女性好字吗
MayAllahKeepThemMasculineWell=愿安拉使他们男性好字吗
MayAllahKeepYouCheerful=愿安拉使你开朗字对字的吗
MayAllahMaintainAllYourLifeFeminine=安拉可能保持所有你生活女性词的词吗
MayAllahMaintainAllYourLifeMasculine=可能真主保持所有你生活男性词对词吗
MayAllahMaintainAllYourLivesFeminine=安拉可能保持所有你生活女性词的词吗
MayAllahMaintainAllYourLivesMasculine=可能真主保持所有你生活男性词对词吗
MayAllahMaintainBothOfYourLives=安拉可能维持你们俩的生活字对字的吗
MayAllahMakeYourRewardGreat=可能真主使你的奖赏伟大字对字的吗
MayAllahProtectBothOfThem=可能真主保护他们字对字的两个吗
MayAllahProtectHer=安拉可能保护她字对字的吗
MayAllahProtectHim=可能真主保护他字对字的吗
MayAllahProtectThemFeminine=真主护佑女性词对词吗
MayAllahProtectThemMasculine=真主护佑阳性词对词吗
MayAllahProtectYouAllFeminineWithGoodness=愿真主保佑你以善字对字的所有女性
MayAllahProtectYouAllFeminine=安拉可能保护你所有女性字一个字吗
MayAllahProtectYouAllMasculineWithGoodness=愿真主保佑你所有男性以善字
MayAllahProtectYouAllMasculine=安拉可能保护您所有男性字一个字吗
MayAllahProtectYouBothWithGoodness=可能真主保护你这两个善良字对字的吗
MayAllahProtectYouBoth=安拉可能保护你这两个字一个字吗
MayAllahProtectYouFeminineWithGoodness=可能真主保护你女性以善字对字的吗
MayAllahProtectYouFeminine=安拉可能保护你女性词对词吗
MayAllahProtectYouMasculineWithGoodness=安拉可能保护你阳刚善字对字的吗
MayAllahProtectYouMasculine=安拉可以保护你们男性词对词吗
MayAllahWillItSoOLordOfTheWorlds=安拉可能将它这么 OLord 的字对字的世界吗
MayEveryYearYouBeInGoodHealthAndBlessings=可能你会身体健康，祝福词对词每年
MayEveryYearYouHaveGoodness=可能你有善字每年
MayGloriousAllahBePleasedWithBothOfThem=愿光荣安拉喜悦他们字对字的两个吗
MayGloriousAllahBePleasedWithHer=愿光荣真主喜悦她字对字的吗
MayGloriousAllahBePleasedWithHim=愿光荣真主喜悦他字对字的吗
MayGloriousAllahBePleasedWithThemFeminine=愿光荣安拉喜悦他们女性词的词
MayGloriousAllahBePleasedWithThemMasculine=愿光荣安拉喜悦他们男性词对词
MayHisGloryBeGlorified=可能他的荣耀得着荣耀字
MayHisGloryBeRaised=可能引发他的荣耀字
MaymunaBintAlHarith=Maymuna Bint Al 哈里斯字
MeaningOfEmptyCentreHighStop=空中心高停止词对词的意义
MeaningOfEmptyCentreLowStop=空中心低停止词对词的意义
MeaningOfEndOfAyah=年底保姆字卡的事的意义
MeaningOfPlaceOfSajdah=地方 Sajdah 字对字的意义
MeaningOfRoundedHighStopWithFilledCentre=圆形高停止与填充中心词对词的意义
MeaningOfSmallHighJeem=小高 Jeem 词对词的意义
MeaningOfSmallHighLamAlef=小高林 Alef 词对词的意义
MeaningOfSmallHighLigatureQafWithLamWithAlefMaksura=小高结扎 Qaf 随林与 Alef Maksura 词对词的意义
MeaningOfSmallHighLigatureSadWithLamWithAlefMaksura=小高位结扎悲伤与林与 Alef Maksura 词对词的意义
MeaningOfSmallHighMeemInitialForm=小高米姆初始形式词对词的意义
MeaningOfSmallHighMeemIsolatedForm=小高米姆意义分离形式字一个字
MeaningOfSmallHighNoon=小高中午词对词的意义
MeaningOfSmallHighRoundedZero=小高意义圆形零字
MeaningOfSmallHighSeen=小高看到词对词的意义
MeaningOfSmallHighThreeDots=小高的三个点词对词的意义
MeaningOfSmallLowSeen=小低见词对词的意义
MeaningOfSmallWaw=小 Waw 词对词的意义
MeaningOfSmallYeh=小 Yeh 词对词的意义
MeaningOfStartOfRubElHizb=开始擦 El Hizb 词对词的意义
Meaning=意字的词
Melting=熔词对词
MessengerOfAllah=字对字的安拉的使者
MethodologyOfQuranicInterpretation=古兰经 》 解释字对字的方法
MidShaban=中期沙班字
MinorAssociation=未成年人协会字
MinorIncorrectPronunciation=轻微不正确的发音词对词
MiraculousAspectsOfTheQuran=神奇的字对字的古兰经 》 的方面
ModerateBounce=温和反弹字
Moderation=节制字
MondayAndThursday=周一和周四字
Month11=Month11 字
Month12=Month12 字
Month3=Month3 字
Month4=Month4 字
Month5=Month5 字
Month6=Month6 字
MonthOfRamadanWhichWasRevealedThereinTheQuranGuidanceToMankind=斋月是其中揭示人类字对字的古兰经 》 指南
Month=月字
Morocco=摩洛哥字
MosqueOfTheProphet=字对字的先知清真寺
MountNour=装载努尔字
MountUhud=山吴字
MuathBinJabal=Muath Bin 山词的词
Muawiyyah=Muawiyyah 字
MuhammadBinAbdullahBinAbduAlMuttalib=默罕默德 · 本 · 阿卜杜拉 · 本 · 阿卜杜 Al Muttalib 字
MuhammadBinAlHasan=默罕默德本 · 阿尔哈桑字对字的
MuhammadBinAli=穆罕默德 · 本 · 阿里字
MusaBinJafar=穆萨 · 本 · 贾法尔字
MysticCommentary=神秘的评注字
NamesAndAttributes=名称和属性词对词
NamesOfCountries=国家字对字的名字
NarrationBasedExegesis=叙述基于训诂词对词
Nasalization=鼻音化字
NasalizeCharacterDoubled=Nasalize 字符逐字翻了一番
NasalPassage=鼻道词对词
Near=附近的字
NegationParticle=否定粒子字
NegativeCommand=消极的命令字
NobleQuran=高贵的古兰经 》 词对词
NominalSentence=名义上句词对词
NoonGhunna=中午 Ghunna 字
NumberPlurality=数字多字
OAllahSendPrayersUponMuhammadAndTheFamilyOfMuhammad=O 真主发送默罕默德和穆罕默德的家人祷告词对词
ObligationOfSufficiency=充分性词对词的义务
ObligationOfTheSelf=自我词对词的义务
ObviousAnalogy=一个显而易见的类比词对词
OChiefs=O 酋长字
OddPrayerAndAfter1=奇怪的祷告和 After1 字
OfTheGuestForTheHost1=宾客为 Host1 词对词的
OfTheResidentForTheTraveler1=居民为 Traveler1 字
OfTheResidentForTheTraveler2=居民为 Traveler2 字
OfTheTravelerAsDawnApproaches1=作为黎明 Approaches1 字对字的旅行者
OfTheTravelerForTheResident1=为 Resident1 字对字的旅行者
OLordGiveMeKnowledge=O 主给我知识字
OMasterSendPrayersAndPeace=O 我的主人|送来你的问候|和祝福|总是|永恒|upon|你心爱的人|最好的|创造的|整体的
OnenessOfAllah=真主字对字的统一性
OnenessOfDivinityAndWorship=合一的神和崇拜字
OnenessOfDivinity=合一的神字
OnenessOfLordshipDominion=合一的贵族统治字
OnenessOfNamesAndAttributes=名称和属性字对字的统一性
OnenessOfWorship=合一的崇拜字
OnWithTheTruth=关于用字对字的真理
Opening=打开字
OpinionBasedExegesis=意见依据训诂词对词
Opinion=词对词的意见
OProphet=O 先知字一个字
OriginalLengthening=原始的延长字
OrnateLeftParenthesis=华丽的左的括号字
OrnateRightParenthesis=华丽的右括号字
OutrightBlindFollowing=彻底盲从字
O=O 字
OYouMankind=O 你是人类字
OYouWhoBelieve=O 你相信字
Pakistan=巴基斯坦字
PartialAbrogation=部分废除字
PartiallyFlexible=部分灵活用词的词
ParticleOfPlace=粒子的词对词的地方
ParticleOfTime=时间词对词的粒子
ParticlesForOaths=宣誓词对词的粒子
ParticlesOfCondition=粒子的状态字
ParticlesOfEmphasis=重点词对词的粒子
ParticlesOfInterogation=粒子的刑讯字
ParticlesOfNegation=粒子的否定词的词
ParticlesOfPlace=粒子的词对词的地方
ParticlesOfTime=时间词对词的粒子
ParticlesWithoutDeclension=颗粒无字词形变化
PassiveParticiplePassiveNoun=被动的分词被动名词字
PassivePastTense=被动的过去时态词对词
PassivePresentTense=被动现在时字
PassiveVerb=被动式动词词对词
PeaceBeUponYouAndMercyOfAllahAndBlessings=愿主赐予你和仁慈的真主和祝福词对词
PeaceBeUponYouAndMercyOfAllah=愿主赐予你和仁慈的真主字对字的
PeaceBeUponYou=愿主赐予你字
PeaceSecure=和平安全字一个字
PeopleOfHadith=圣训学家词对词的人
PeopleOfRealities=词对词的现实的人
PeopleOfReasoningOpinion=人的推理认为词的词
PeopleOfTheBook=字对字的书的人
PeopleOfTrueReality=人的真正的现实字
Philippines=菲律宾字
Phonation=发声词对词
PhraseForAllahIsGreatestOfCommenceningPrayer=短语的真主是伟大的 Commencening 祷告词对词
PhraseForAllahIsGreatestOfConsecratedState=短语的真主是伟大的神圣状态字
PhraseForAllahIsGreatestOfTransition=短语的真主是过渡的伟大词对词
PlacingChildrenUnderAllahsProtection1=Allahs Protection1 字下放置儿童
PlacingTheDeceasedInTheGrave1=将死者放在 Grave1 字
PleasedWithDecree=高兴与旨令字
PointingConstruction=指出建设字
PointingNouns=指向名词字
PointingNoun=指向名词字
PossessionConstructionLikeNounsForTimePlace=拥有像名词施工时间地点字
PossessionConstruction=拥有建设字
PossessionParticles=藏有粒子字
PossessiveConstruction=占有欲建设字
Practical=实用字
PracticesOfThePeopleOfMedina=人民的麦地那词对词的做法
PrayerSaidDuringAWindStorm1=祷告时风吹 Storm1 字说
PrayerSaidDuringAWindStorm2=祷告时风吹 Storm2 字说
PrayersUponTheProphet=字对字的先知的祷告
PrayTime8=祷告词对词 Time8
PrayTime9=祷告词对词 Time9
PreciseMethodicalRecitation=精确有条不紊朗诵词对词
Predicate=谓词字
PresentOrFutureTenseVerb=现在或将来紧张动词词对词
PresentTensePossessionParticles=现在时态拥有粒子字
PreservedTablet=保存的片字
ProphetOfAllah=真主字对字的先知
ProphetsOfAllah=真主字对字的先知
ProstratingDueToQuranRecitation1=因为古兰经 》 Recitation1 字对字的礼佛
ProstratingDueToQuranRecitation2=因为古兰经 》 Recitation2 字对字的礼佛
ProstrationOfForgetfulness=厥脱的健忘字
PurificationFromPhysicalFilth=从物理污秽词对词的净化
PurificationFromSpiritualFilth=从精神污秽词对词的净化
PurificationOfTheSoul=O 真主|你给|我的灵魂|其虔诚|你净化它|你 (单独)|最佳|谁|净化它|你 (单独)|其监护人|和它的主人
Pus=脓液字
QaasimBinMuhammad=本 · 穆罕默德 · 伽字
Quarter=季度字
QuestionMark=问号字
QuotationMark=引号字
QuranicGrammar=古兰经 》 语法词的词
QuranicMetaphor=古兰经 》 隐喻词对词
QuranicSciences=古兰经 》 科学字
QuranPreservedInUthmaniScript=古兰经 》 在 Uthmani Script 中保留字
RaaHeaviness=Raa 沉重字
RaaLightness=Raa 轻盈字
RaisingHandsInPrayer=举手祷告词对词
RamlahBintAbiSufyan=Ramlah · 宾特 · 阿比扬字
RapidRecitation=快速背诵字
RationalInsights=合理的见解字
RationalLogicalMetaphorMetonymy=理性的逻辑隐喻转喻词对词
RayhanaBintZayd=Rayhana · 宾特 · 宰字
RealisticJurisprudence=现实主义法学字
ReasonsForRevelation=启示录字对字的原因
RelatedOpinionBasedExegesis=相关的意见依据训诂词对词
RelativeAdjective=相对形容词词对词
RelativePlaceNouns=相对的地方名词字
RelativePronoun=关系代词字
RelativeTimeNouns=相对时间名词字
Remembrance1=Remembrance1 字
Remembrance2=Remembrance2 字
RemembranceAfterGivingPeaceOfPrayer1=后给 Prayer1 字对字的和平的纪念
RemembranceAfterGivingPeaceOfPrayer2=后给 Prayer2 字对字的和平的纪念
RemembranceAfterGivingPeaceOfPrayer3=后给 Prayer3 字对字的和平的纪念
RemembranceAfterGivingPeaceOfPrayer4=后给 Prayer4 字对字的和平的纪念
RemembranceAfterGivingPeaceOfPrayer7=后给 Prayer7 字对字的和平的纪念
RemembranceAfterGivingPeaceOfPrayer8=后给 Prayer8 字对字的和平的纪念
RemembranceAtSittingOrGathering1=在坐着或 Gathering1 字对字的纪念
RemembranceBeforeSleeping10=前 Sleeping10 字对字的纪念
RemembranceBeforeSleeping11=前 Sleeping11 字对字的纪念
RemembranceBeforeSleeping13=前 Sleeping13 字对字的纪念
RemembranceBeforeSleeping4=前 Sleeping4 字对字的纪念
RemembranceBeforeSleeping5=前 Sleeping5 字对字的纪念
RemembranceBeforeSleeping6=前 Sleeping6 字对字的纪念
RemembranceBeforeSleeping7=前 Sleeping7 字对字的纪念
RemembranceBeforeSleeping8=前 Sleeping8 字对字的纪念
RemembranceBeforeSleeping9=前 Sleeping9 字对字的纪念
RemembranceFifth=我已接纳|真主|作为主，|伊斯兰|作为一种生活方式|和穆罕默德 (愿他平安)|作为一个先知|和 (安拉) 的使者。|(背诵在阿拉伯语三倍)。
RemembranceFirst=无|有权受崇拜|but|您|荣耀是你|真正|我一直|在|做错事的人
RemembranceFourth=O 真主!|尊崇和怜悯|打开||默罕默德 (和平和他的祝福)，|你的仆人，|你们的先知，|和你的使者，|先知|文盲|和后|他的家人|和同伴，|并授予他们和平。
RemembranceSecond=对我们来说足够|真主|和他是最好的|处置者事务|优秀|赞助人|和什么优秀|帮助器
RemembranceSeventh=O 真主!||我们寻求避难|在你|从||关联其他|和你一起|所有内容|虽然我们都知道它，|我们寻求悔改|为将其他的东西与你相关联|非|虽然我们都知道它。
RemembranceSixth=O 我的主!|给你|所有的赞美是到期|作为|适合|到你光荣|状态|和你很棒|主权。
RemembranceThird=有没有|强度|还有没有|力量|除了|以物配主|高|最高人民法院
RepelTheirEvilByMeansOfWhatIsBest=用什么是最好的字对字的排斥他们的邪恶
Repetition=重复字
RepresentativeStem=代表干字
ResponseStatementAfterCondition=回应声明后状态字
Restraint=克制字
ResurrectionSending=复活发送字
ReturningAGreetingToADisbeliever1=同意约见回到 ADisbeliever1 字
ReturningASupplicationAfterHavingBestowedAGiftOrCharityUponSomeone1=领受礼物或慈善机构 Someone1 字的后返回 ASupplication
ReturningSupplicationForForgiveness1=返回为 Forgiveness1 祈求字
RiadAlJannah=里亚德阿尔奎字
Ridaa=Ridaa 字
RightCurlyBracket=右花括号字
RighteousDealings=公义字
RighteousDeeds=善事的字
RightOfAllah=真主字对字的权利
RightPointingDoubleAngleQuotationMark=指着双角引号词对词的权利
RightSquareBracket=字的右方括号
RuleInImpliedMeaningAgreesWithStatedMeaning=规则中隐含意义同意陈述意思字
RuleInImpliedMeaningIsContrapositiveToStatedMeaning=规则中隐含的意义是对陈述意思字对字的逆
RuqayyahBintiMuhammad=宾蒂默罕默德 Ruqayyah 字
SaadBinWaad=萨阿德 Bin Waad 字
SaalimMawlaaAbeeHuthayfah=Saalim Mawlaa 不亦乐乎 Huthayfah 字
SacredMosque=神圣清真寺字
SadBinAbiWaqqas=悲伤的 Bin Abi 沃字
SadBinMalik=伤心本 · 马利克字
SaeedBinZaid=赛义德 · 本 · 扎伊德字对字的
SafeguardYourselfFromHeWhoYouHaveBeenGoodTo=保护自己免受他那些你一直对字一个字好
SafiyyaBintHuyayy=Safiyya Bint Huyayy 字
SahihAlBukhari=阿尔布哈里圣训字
SahihMuslim=圣训穆斯林字
SaidToOneOfferingADrinkOrTheOneWhoIntendedToDoThat1=若要对一种可以提供小酌时或打算去做: (1) 词对词的人说:
SalawatSupplicationAfterTalbiah=O 真主|送来问候|upon|母版|默罕默德|和后|家庭|母版|默罕默德|正如|你送来问候|upon|亚伯拉罕 ·|和后|家庭|亚伯拉罕 ·|并送上祝福|upon|母版|默罕默德|和的家人|母版|默罕默德|正如|你送祝福|upon|亚伯拉罕 ·|和后|家庭|亚伯拉罕 ·|in|所有的世界|你真是|值得称赞|强大
SalutationsUponYouOfAllah=在你身上的真主字对字的称呼
SaudiArabia=沙乌地阿拉伯字
SawdaBintZama=黑胆质 · 宾特 · 扎字
SayCallUponAllahOrCallUponTheMostMercifulWhicheverNameYouCallToHimBelongTheBestNames=说真主呼吁或呼吁最仁慈的人无论你叫他的名字属于最好的名字字
Scale=规模字
ScientificExegisis=科学 Exegisis 字
Scorching=灼热的字
SecondCreed=孤独|否|合作伙伴|有他|和我的见证|那|默罕默德|他的仆人|和信使
SecondParticlePossessionConstruction=第二个粒子拥有建设字
Second=第二字
SeekingForgivenessAndRepentance3=我寻求宽恕|真主|强大，|谁|没有|值得一的崇拜|除了|他，|生活，|是永恒的|我后悔|给他。
SeekRefugeWithAllahFromSatanRejected=寻求庇护真主从撒旦拒绝字一个字
SeenNoted=看到著名字
SeenRequired=看到所需字
Semicolon=分号字
SendBlessingsFirst=O 真主|发送你的怜悯|打开|默罕默德|和后|后人|他的|作为|你发送你的怜悯|打开|亚伯拉罕 ·|和后|后人|他的|你真是|最受赞赏|最光荣|和传递你的祝福|打开|默罕默德|和后|后人|他的|作为|你寄给你的祝福|打开|亚伯拉罕 ·|和后|后人|他的|in|世界|你真是|最受赞赏|最光荣
SendBlessingsSecond=O 真主|发送你的怜悯|打开|默罕默德|和后|后人|他的|作为|你发送你的怜悯|打开|亚伯拉罕 ·|和后|后人|他的|你真是|最受赞赏|最光荣|O 真主|传递你的祝福|打开|默罕默德|和后|后人|他的|作为|你寄给你的祝福|打开|亚伯拉罕 ·|和后|后人|他的|你真是|最受赞赏|最光荣
Sense=字对字的意义
SeparatedLengtheningGreatConnection=分隔延长大连接词对词
SeparatedLengtheningSmallConnection=分隔延长小连接词对词
SettlingADebt1=解决 ADebt1 字
SettlingADebt2=解决 ADebt2 字
SettlingOfRightsBetweenBelievers=定居的权利之间信徒字
Simile=比喻词的词
SixthCreed=O 真主|当然|我寻求保护|和你一起|从|那|我将与你的伴侣相关联|所有内容|和我|知道|it|和我寻求宽恕你|为此|非|我知道|it|我后悔|从它|我让自己自由|从|不敢相信|和多神教|与谬误|和背咬|与创新|和告诉故事|和恶行|和责备|和不服从|所有这些|和我提交|和我说|有没有|神|除了|真主|默罕默德|信使|真主
SmallBounce=小幅反弹字
SmokeOfHell=地狱词对词的烟
SoftLengthening=软延长字
SoundFemininePlural=健全女性复数词对词
SoundMasculinePlural=健全的男性复数词对词
Space=空间字
SpeechOfAllah=真主字对字的讲话
StablizationLengthening=稳定延长字
StatedSimile=表示比喻词的词
StateofMajorRitualImpurity=国家主要仪式杂质字
SteadyLengtheningStop=稳定延长停止词对词
StoppingOrLodgingSomewhere1=停止或倒伏 Somewhere1 字
Stories=词对词的故事
Strength=字对字的力量
StrongerReasonArgument=更强的 Reason 参数字
StudentsOfFollowers=学生的字对字的追随者
StudyOfRhetoricEloquence=修辞口才词对词的研究
SubjectNominalSentence=主题名义句词对词
SublimeAndMighty=崇高和强大字
SubordinatorsBeginningConditionalClauses=开始条件状语从句词对词的手下
SubstituteLengthening=替代延长字
SubstitutionOfAPartForAWhole=替代分开推进器字
SubstitutionOfPartForTheWhole=替代整个逐字逐句的一部分
Sudan=苏丹字
SuhaylBinAmr=苏海勒宾 Amr 字
SumayyaBintiKhayatt=Sumayya 宾 Khayatt 字
SummarizedBlindFollowing=总结了盲从字
SunanAbiDawood=圣训字
SunanAlTirmidhi=苏南 Al 替字
SunanIbnMaja=苏南 · 伊本 · 玛雅字
SuperscriptAlefDaggerAlif=上标 Alef 匕首曝气字
SupplicationAfterSalawatSupplication=O 真主|事实上|我寻求你|你的祝福|和天堂|我寻求庇护与你同在|从|愤怒|与地狱。
SupplicationForArrivingAtMakkah=O 真主|真正|此|圣所是|你神圣的地方|和这个圣城是|你的城市|和平中顺是|你平安|然后禁止我|从|地狱火|把我拯救|从|你的惩罚|日时|你愿意提高|你的仆人
SupplicationOfOpening=开放词对词的恳求
Taaif=Taaif 字
TahdhibAlAhkam=Tahdhib 萨克字
Talbiah=我已经回应你|O 真主|我已经回应你|我已经回应你|有没有|合作伙伴|给你的|我已经回应你|真正|所有的赞美|和所有赏金|给你的|与主权|有没有|合作伙伴|给你的
TalhaBinObaidullah=本 · 奥贝杜拉 Talha 字
Tall=高字
TaughtMankindWhatNotHeKnew=他知道字什么不教导人类
TestifyingCreedOfIslamFirstPart=作证的伊斯兰教第一部分字对字的信条
TestifyingCreedOfIslamSecondPart=作证的伊斯兰教第二部分字对字的信条
TestifyingCreedOfIslam=证明信仰伊斯兰教字
ThanksAllPraiseAndThanksIsToAllah=谢谢所有的赞美和感谢是对阿拉字
TheAbaser=Abaser 字
TheAcknowledgingOne=承认一词对词
TheAllAuthoritativeOne=所有权威一词对词
TheAllAwareOneTheAllSeeing=大家都知道一个字都看到一个字
TheAllAwareOne=大家都知道一个词的词
TheAllCompelling=所有令人信服的逐字逐句
TheAllEnumeratingOne=所有枚举一个字
TheAllHearerTheAllKnowingOne=所有听众都知道一个字对字的
TheAllHearerTheAllSeeing=所有听众都看到逐字逐句
TheAllHearerTheClose=所有的听话者密切逐字逐句
TheAllHearer=所有的听话人字
TheAllKnowingOneTheAllAwareOne=所有知道人都知道一个词的词
TheAllKnowingOneTheClementOne=所有知道人克莱门特的一个字
TheAllKnowingOneTheOmnipotentOne=我知道一个万能的人字对字的所有
TheAllKnowingOneTheWiseOne=我知道一个明智的人字对字的所有
TheAllKnowingOne=都知道一个词的词
TheAllNobleOne=所有贵族一词对词
TheAllObservingWitness=所有观测的证人字
TheAllPervadingOneTheAllKnowingOne=弥漫一知道一词对词的所有这一切
TheAllPervadingOneTheWiseOne=所有弥漫一明智一词对词
TheAllPervadingOne=所有弥漫一词对词
TheAllPrevailingOne=所有流行一个词对词
TheAllSeeing=字都看见一个字
TheAssemblerOfScatteredCreations=此汇编程序分散创作词对词
TheBeautiful=美丽一词的词
TheBeneficent=仁慈的逐字逐句
TheBenignOneTheMerciful=良性的一个仁慈逐字逐句
TheBenignOne=良性的一个字
TheBestowerOfBenefits=好处字对字的安放
TheBestowerOfSufficiency=充分性词对词的安放
TheBestower=字对字的授与者
TheBountifulOne=丰收一词对词
TheBrilliant=字对字的辉煌
TheClear=明确逐字逐句
TheClementOneTheMerciful=克莱门特的一个仁慈逐字逐句
TheClementOneThePardoner=克莱门特的一个热播词的词
TheClementOne=克莱门特的一个字
TheClose=密切逐字逐句
TheContinuousCreator=连续的造物主字
TheCoverer=防尘罩字
TheCreatorTheAllKnowingOne=造物主全知一字
TheCreator=造物主字
TheDaybreak=黎明字
TheDayOfArafah1=Arafah1 字对字的一天
TheDayOfArafah=阿拉法特字对字的一天
TheDayOfAshura=阿舒拉节字对字的一天
TheDistressor=Distressor 字
TheDoerOfGood=好词对词的实干家
TheDominantOne=占主导地位的一个字
TheElevatingOne=提升一词对词
TheEmbodimentOfJustice=字对字的正义的化身
TheEmbodimentOfPeace=和平词对词的化身
TheEmbodimentOfTruth=字对字的真理的化身
TheEternalInheritor=永恒的继承人字
TheEternalLordTheAllAuthoritativeOne=永恒的主所有权威一词对词
TheEternalLordTheEmbodimentOfTruth=永恒的主字对字的真理的化身
TheEternalLordTheMostSacred=永恒的主词的最神圣的字眼
TheEternalLord=永恒主词的词
TheEternalPossessorOfSovereignty=永恒的主权字对字的私钥的持有人
TheEtiquetteOfPraisingAFellowMuslim1=礼仪的赞美 AFellow Muslim1 字
TheEtiquetteOfPraisingAFellowMuslim2=礼仪的赞美 AFellow Muslim2 字
TheEverAcceptorOfRepentanceTheMerciful=曾经承兑人悔改仁慈的字
TheEverAcceptorOfRepentanceThePardoner=过的悔改热播词对词的承兑人
TheEverAcceptorOfRepentanceTheWiseOne=曾经的悔改明智一词对词的承兑人
TheEverAcceptorOfRepentance=曾经的忏悔词对词的承兑人
TheEverLivingTheBountifulOne=曾经的生活丰富一词对词
TheEverLivingTheCoverer=过生活防尘罩字
TheEverLivingTheSelfSubsistingOne=过生活自我生存一词对词
TheEverLiving=过生活字一个字
TheEverSurvivingOne=曾经尚存一词对词
TheEvilEye=邪恶之眼的字
TheEvolver=字对字的进化
TheExpeditingOne=加快一词对词
TheExtender=扩展程序字
TheExtensivelyEnduringOne=广泛持久的一个字
TheExtremelyExaltedOne=极其崇高的一词的词
TheEyeOfSatan=撒旦词对词的眼睛
TheFirmOne=企业一词对词
TheFlawlessShaper=完美的牛头刨床字
TheFountainHeadOfTruthTheMerciful=喷水头的真相仁慈字
TheFountainHeadOfTruth=喷水头的字对字的真相
TheGathererOfMankind=人类词对词的收集器
TheGentle=字对字的温柔
TheGiver=字对字的记忆传承者
TheGloriousOne=光荣的一个字
TheGood=好字
TheGreatForgiver=伟大的宽恕字
TheGreatOne=伟大一词对词
TheGuardingOne=守卫一词对词
TheGuideToPathOfRectitude=指南 》 清廉词对词的路径
TheHelper=字对字的帮手
TheHolderOfSupremeAuthority=最高当局字对字的持有人
TheHonorerBestower=Honorer 安放字
TheImpartialJudge=字位公正的法官
TheImperceptible=不知不觉逐字逐句
TheInfiniteLastOne=无限的最后一个字
TheInflictorOfDeath=Inflictor 的死亡字
TheInfuserOfFaith=信念字对字的输液器
TheInfuserOfNewLife=新生命词对词的输液器
TheIrresistable=无法抗拒逐字逐句
TheJustOne=只是一个字
TheKnowerOfSubtletiesTheAllAwareOne=个人的微妙之处都知道一个字对字的知
TheKnowerOfSubtleties=个人的词对词的微妙之处知
TheLord=主词的词
TheLovingOne=有爱心的人字
TheMagnificentOneTheClementOne=华丽的一个的克莱门特的一个词的词
TheMagnificentOne=壮观的一个字
TheMaintainerOfLife=维护者生活字
TheMajesticOne=雄伟壮观的一个字
TheMasterLord=主耶和华字
TheMaster=主词的词
TheMatterHasBeenDecreed=这件事已经被钦点字
TheMercifulTheLovingOne=仁慈的爱一个词的词
TheMercifulThePardoner=怜恤热播词的词
TheMercifulTheSupremePardoner=仁慈的人最高的热播词的词
TheMerciful=仁慈的逐字逐句
TheMightyOneTheAllAuthoritativeOne=大能者的所有权威的一个词的词
TheMightyOneTheAllKnowingOne=强大的人都知道一个词的词
TheMightyOneTheMerciful=大能者仁慈逐字逐句
TheMightyOneThePardoner=威势热播词的词
TheMightyOneTheSoleLaudableOne=强大的一个唯一值得称赞的一词的词
TheMightyOneTheSupremeBestower=强大的一个最高安放词的词
TheMightyOneTheWiseOne=强大的一个智者一词的词
TheMightyOne=强大的一个字
TheMostGenerous=最慷慨逐字逐句
TheMostHigh=最高逐字逐句
TheMostHolyFromAllWeakness=最神圣的所有弱点字对字的
TheMostSacred=通过 Word 最神圣的字眼
TheNamesOfAllahAreBestFixedInTheBookAndTradition=真主的名字最好被固定的在书和传统词对词
TheNamesOfAllahAreBest=真主的名字是最佳字
ThenHeHasDisbelieved=然后，他已不相信字一个字
TheNobleQuran=高贵的古兰经 》 词对词
ThenTrulyThePartyOfAllahAreTheTriumphant=然后真正的真主党是胜利逐字逐句
TheOdd=奇数词对词
TheologyOfThePeopleOfTraditionAndTheGroup=在传统的组字对字的人们的神学
Theology=神学字
TheOmnipotentKing=全能王字
TheOmnipotentOne=万能的一个字
TheOneGod=一个神字
TheOneWhoCures=一个人治愈字
TheOneWhoRecompenses=那个报偿字一个字的人
TheOnlyOneTheAllPrevailingOne=唯一的所有流行一个词的词
TheOnlyOne=只有一个字
TheOriginator=字对字的原始发件人
TheOwner=字对字的所有者
ThePardonerTheAcknowledgingOne=承认一字对字的热播
ThePardonerTheClementOne=克莱门特一字对字的热播
ThePardonerTheLovingOne=有爱心的人字对字的热播
ThePardonerTheMerciful=仁慈的逐字逐句热播
ThePardoner=字对字的热播
ThePeopleOfTraditionAndTheGroup=在传统的组字对字的人们
ThePerceptible=字可感知一个字
ThePointingOne=指向一个字
ThePossessorOfMajestyAndHonor=陛下和荣誉字对字的私钥的持有人
ThePossessorOfTwoHorns=两个喇叭字对字的私钥的持有人
ThePowerful=强大的逐字逐句
ThePrayersOfAllahUponHimAndPeace=真主在他身上和和平词对词的祈祷
ThePrayersOfAllahUponHimHisFamilyAndPeace=真主对他他的家人和和平词对词的祈祷
ThePreserverOfSafety=保护者的安全词对词
ThePreventer=字对字的防喷器
ThePrimeLight=主要光字一个字
TheProcrastinator=拖延者字
TheProstratingOne=伏一词对词
TheProtectingAssociate=保护关联词的词
TheProviderOfGuidance=字对字的指导供应商
TheProvider=提供商字
TheReckoningOne=推算一个字一个字
TheRecognizerTheAllKnowingOne=全知一字对字的识别
TheRecognizerTheClementOne=克莱门特一字对字的识别
TheRecognizer=识别器字
TheReducer=减速机字
ThereIsNoPowerAndNoMightExceptWithAllahMostHighMostMagnificent=有没有权力和没有可能除了与真主最高最宏伟字一个字
ThereIsNoPowerAndNoMightExceptWithAllah=有没有权力和没有可能除了与真主字
TheRespondingOne=响应一词对词
TheRestorer=恢复系词对词
TheRestrictingOne=限制一个字
TheRetaliator=Retaliator 字
TheRighteous=义人字
TheSelfSubsistingOne=自我的生存一词对词
TheSelfSufficientOneTheBountifulOne=自我的足够一个丰富一词的词
TheSelfSufficientOneTheClementOne=自我的足够一的克莱门特的一个词的词
TheSelfSufficientOneTheSoleLaudableOne=自我的足够一个唯一值得称赞的一词的词
TheSelfSufficientOne=自我足够一词对词
TheShy=字对字的害羞
TheSickWhoHaveRenouncedAllHopeOfLife1=病人已放弃所有希望的 Life1 字
TheSickWhoHaveRenouncedAllHopeOfLife2=病人已放弃所有希望的 Life2 字
TheSickWhoHaveRenouncedAllHopeOfLife3=病人已放弃所有希望的 Life3 字
TheSoleLaudableOneTheGloriousOne=唯一值得称赞的光荣的一个词的词
TheSoleLaudableOne=唯一值得称赞一词对词
TheSoleOne=唯一的一个字
TheStrongOneTheMightyOne=坚强的人的强大的一个词的词
TheStrongOne=坚强的人字
TheSublimeOneTheAllAwareOne=崇高的人的都知道一个词的词
TheSublimeOneTheGreatOne=崇高的一个伟大一词的词
TheSublimeOneTheMagnificentOne=崇高的一个壮观一个词的词
TheSublimeOneTheWiseOne=那个崇高的智者一词的词
TheSublimeOne=崇高的一个字
TheSupremeBestower=最高安放字
TheSupremeInHonor=在词对词的荣誉最高
TheSupremeOwnerOfSovereigntyAndGreatestThingsAndSupremeGlory=主权和最棒的事情和最高荣耀词对词的最高所有者
TheSupremePardonerTheOmnipotentOne=最高的热播万能一词对词
TheSupremePardonerThePardoner=最高的热播热播字
TheSupremePardoner=最高的热播字
TheSupremeProvider=最高提供商字
TheSupremeSolverTheAllKnowingOne=最高的规划求解全知一字
TheSupremeSolver=最高的规划求解字
TheSustainer=字对字的维系者
TheSustainingOne=维持一个字
TheTaaOfFemininity=女性词对词的大亚
TheTaker=刺字
TheTalbiyah1=Talbiyah1 字
TheTotalProvider=共商字
TheTruthfulOne=真实的一个字
TheUniqueOneOfTheHeavensAndEarth=一个独特的天地字一
TheUniqueOne=独特的一个字
TheUniversalTrustee=普遍的受托人字
TheVeryFirst=第一个字一个字
TheWatchfulOne=警惕一词对词
TheWhiteMoonEighth=欢迎|一种好方式|你自己打给我们
TheWhiteMoonFifth=哦|我们的信使|在我们中间
TheWhiteMoonFirst=哦，上升|洁白的月亮|在我们
TheWhiteMoonFourth=对他来说|世卫组织邀请我们|向安拉|方式
TheWhiteMoonSecond=开始时间|山谷|所谓的"再见"
TheWhiteMoonSeventh=你带来了|贵族|对这座城市
TheWhiteMoonSixth=谁来|与诫 》|必须服从
TheWhiteMoonThird=它是现任|要显示的态度|在我们身上
TheWiseOneTheAllAwareOne=聪明的人都知道一个词的词
TheWiseOneTheAllKnowingOne=聪明的人都知道一个词的词
TheWiseOneTheSoleLaudableOne=聪明的人的唯一值得称赞一个词的词
TheWiseOne=聪明的人字
ThirdCreed=荣耀|向安拉|和好评|向安拉|还有没有|神|除了|真主|和阿拉|最大|和没有|might|和没有|力量|除了|以物配主|最高|大多数的壮丽
ThreeLetterRootVerb=三信根动词词对词
Throat=词对词的喉咙
Time=时间词的词
ToADisbelieverWhenSneezes1=到 ADisbeliever 时 Sneezes1 词的词
Today=今天字
Tongue=舌字
ToOneWhoDoesYouAFavor1=到一个谁做你 AFavor1 字对字的
ToOneWhoHasOfferedYouSomeOfHisWealth1=一个人什么也提供了一些他的 Wealth1 字
ToOneWhoPronouncesLoveForYouForAllahsSake1=向一位字对字的发音为 Allahs Sake1 对你的爱
ToTheDebtorWhenHisDebtIsSettled1=向债务人时他的债务是 Settled1 字
ToTheNewlyWed1=向新 Wed1 字
ToWardOffTheDeceptionOfTheObstinateDevils1=抵御的顽固性 Devils1 字对字的欺骗
TraditionObligatory=传统强制字一个字
TraditionVoluntary=传统自愿字
Transcendence=超越字
TransitiveVerb=及物动词词对词
TrulyAllahIsWithThePatient=真正真主是字对字的患者
TrulyAllahLovesWhenOneWhoWorksDoesTheWorkWell=阿拉真正爱当一个人工作不工作好字
TrulyFromAllahWeComeAndToHimWillReturn=真正从真主我们过来给他将返回字
TrulyWithHardshipIsEase=真正的困难是易用性字
TrulyYouAreOnAnExaltedStandardOfCharacter=你真是对字符字对字的崇高标准
TwoLips=两片嘴唇字
TypesOfSentences=类型的词对词的句子
UbayyBinKab=伍柏耶宾甲字
UmarBinAlKhattab=欧麦尔滨基地哈塔卜字
Umayyad=倭马亚字
UmmKulthumBintiMuhammad=乌库勒苏姆宾默罕默德词的词
UnityOfAllah=真主字对字的统一
UniversalPrescription=通用的处方字
UnusualQuranicTerms=不寻常的古兰经 》 条款字
UponBothOfThemBePeace=在他们两个字对字的和平
UponBreakingFast1=于打破 Fast1 字
UponBreakingFast2=于打破 Fast2 字
UponCompletingAblution1=我可以作证|那|none|有权受崇拜|but|真主|孤独|否|合作伙伴|有他|和我的见证|那|默罕默德|是他的奴隶|和他的使者
UponCompletingAblution2=O 真主|让我|其中|那些人转向你悔改|让我|其中|那些人都的纯化
UponCompletingTheMeal1=在完成 Meal1 字
UponCompletingTheMeal2=在完成 Meal2 字
UponEncounteringAnEnemyOrThoseOfAuthority1=当遇到敌人或那些 Authority1 字
UponEncounteringAnEnemyOrThoseOfAuthority2=当遇到敌人或那些 Authority2 字
UponEnteringATownOrVillage1=进入 ATown 或 Village1 字
UponEnteringTheHome1=量的名称|真主|我们输入|量的名称|真主|我们离开|和后|我们的主安拉|我们依赖于
UponEnteringTheMosque1=我寻求庇护|在安拉|万军之耶和华，|由他的脸|高尚，|通过他的力量|原始，|从|撒旦|弃儿。|(在名称中|真主，|和祝福)。|(与和平|安宁|信使|真主)。|O 真主|开启|在我面前|门|你的仁慈。
UponExperiencingFearUnrestApprehensivenessDuringSleep1=一旦经受恐惧不安恐惧期间 Sleep1 字
UponHearingThunder1=在聆讯 Thunder1 字
UponHerBePeace=在她身上有和平字
UponHimBePeace=在他身上是和平字
UponHimHisFamilyPrayersAndPeace=他他家庭的祷告和和平字
UponHimOneThousandPrayersAndPeace=他一千祈祷和和平字
UponHimPrayersAndPeace=他的祈祷和和平字
UponLeavingTheMosque1=在名称中|真主，|和祝福|与和平|安宁|信使|真主。|O 真主，|真正|我问|对于|您的青睐，|O 真主，|保护我|从|撒旦|弃儿。
UponReceivingPleasingOrDispleasingNews1=在收到讨人喜欢或得罪新闻动态 1 字
UponRisingFromBowing1=后从 Bowing1 字对字的上升
UponRisingFromBowing2=后从 Bowing2 字对字的上升
UponRisingFromBowing3=后从 Bowing3 字对字的上升
UponSeeingEarlyOrPrematureFruit1=见状早期或过早 Fruit1 字
UponSeeingSomeoneInTrialOrTribulation1=看到有人在审判或 Tribulation1 字
UponSightingTheCrescentMoon1=在瞄准新月 Moon1 字
UponSneezing1=在 Sneezing1 字
UponThemBePeaceFeminine=在他们身上是和平女性词的词
UponThemBePeaceMasculine=在他们身上是和平男性词对词
UthmanBinAffan=奥斯曼 · 本 · 阿凡字
UthmanicScript=Uthmanic 脚本字
VarianceDifferences=方差差异字
VerbalSentence=动词句词对词
VerbInThePastTense=动词过去时态词对词
VerilyAndItsSisters=实在和它的姐妹字
VerseOfTheSword=剑字对字的诗
VerseOfTheThrone=字对字的宝座的诗句
VersesOfRefuge=避难所字对字的诗句
Vibration=振动字
VisitingTheGraves1=前往 Graves1 字
VowellessMeemAssimilatingSmallIdentical=于米姆同化小相同字一个字
VowellessMeemClearGreater=于米姆清除更多字
VowellessMeemClear=于米姆清楚字
VowellessMeemHide=于米姆隐藏字
VowellessNoonAssimilatingNasalization=于中午同化鼻音化字
VowellessNoonAssimilating=于中午同化词对词
VowellessNoonClear=于中午清晰字
VowellessNoonCovered=于中午覆盖字
VowellessNoonHideHeaviness=于中午隐藏沉重字
VowellessNoonHideLightness=于中午隐藏轻盈字
VowelLetter=元音字母词的词
WaraqahBinNawfal=沃拉格宾诺字
WawWithHamzaAbove=带上喉塞音符逐字逐句 waw
Weakness=词对词的弱点
Week=周字
WeHavePutTrustInAllah=我们倚靠在安拉字
WeightedCompulsoryLengtheningLetters=加权义务教育延长字母词的词
WeightedCompulsoryLengtheningWords=加权义务教育延长词字
WeSeekRefugeWithAllah=我们寻求避难以物配主词的词
WhenAtMountSafaAndMountMarwah1=当在装载 Safa 和装载 Marwah1 字对字的
WhenBreakingFastInSomeonesHome1=当快速磨合某人 Home1 字
WhenClosingTheEyesOfTheDeceased1=关闭 Deceased1 词对词的眼睛时
WhenEnteringTheMarket1=当进入 Market1 词的词
WhenFeelingSomePainInTheBody1=当感觉有些疼痛在 Body1 字对字的吗
WhenGoingToTheMosque1=O 真主|地方|in|我的心|光|和上|我的舌头|光|中和|我的耳朵|光|中和|我的视线|光|并且|我上面|光|并且|我下面|光|及至|我的权利|光|及至|我的左边|光|并且|在我面前|光|并且|在我身后|光|地方|in|我的灵魂|光|扩大|对我来说|光|和放大|对我来说|光|生成|对我来说|光|让我|一盏灯|O 真主|赐予我|光|和地方|in|我的神经|光|中和|我的身体|光|中和|我的血|光|中和|我的头发|光|中和|我的皮肤|光|(O 真主|闭合|对我来说|一盏灯|in|我的坟墓|和光|in|我的骨头)|(增加我在|光|增加我在|光|增加我在|光)|(格兰特|我|光|upon|光)
WhenInFearOfAfflictingSomethingOrSomeoneWithOnesEye1=在恐惧的困扰与那些 Eye1 字对字的某人或某物时
WhenInFearOfAPeople1=当在 APeople1 字对字的恐惧
WhenInsultedWhileFasting1=当同时 Fasting1 字对字的侮辱
WhenItRains1=当它 Rains1 字
WhenLeavingTheHome1=量的名称|真主|我信任|in|真主|有没有|might|和没有|力量|除了|由阿拉
WhenLeavingTheHome2=O 真主|I|寻求庇护|在你|以免|我误导别人|或者|我是被误导了别人|以免|我让别人犯错|或者|我被造成孰能无过|以免|我辱骂他人|或者|被滥用|和莱斯特|我乱来|或者|别人的愚蠢|会见
WhenMountingAnAnimalOrAnyMeansOfTransport1=当越来越多的动物或任何手段 Transport1 词的词
WhenPraised1=当 Praised1 词的词
WhenSlaughteringOrOfferingASacrifice1=当屠宰或提供 ASacrifice1 字
WhenSomeoneBlessesYou1=当有人祝福 You1 字
WhenSomeoneElseWearingANewGarment1=穿破了|然后它被取代|(通过)真主|最高
WhenSomeoneElseWearingANewGarment2=穿上衣服|新建|过一种生活|值得一赞|死了依然是|烈士
WhenSomethingIsDifficult=当一些东西是很难字
WhenStrickenWithAMishapOrOvertakenByAnAffair1=当患曾经或超越由 Affair1 字
WhenTurningOverInTheNight1=当在 Night1 翻字的词
WhenVisitingTheSick1=当前往 Sick1 词的词
WhenVisitingTheSick2=当前往 Sick2 词的词
WhenWakingUp1=赞美是|向安拉|谁|给我们的生活|之后||他已经导致了我们去死|对他|是返回
WhenWakingUp2=没有|值得一的崇拜|but|真主|孤独|否|合作伙伴|对他来说|他|是统治|对他|属于所有的称赞|他是|upon|全部|事情|功能强大|荣耀|是对阿拉|表扬|是对阿拉|没有|值得一的崇拜|but|真主|真主|是最大|有没有|might|和没有|力量|除了|真主的许可|崇高|强大|我的主|原谅我
WhenWakingUp3=表扬|(是) 对阿拉|谁|给了力量|到|我的身体|和返回|对我来说|我的灵魂|和允许|我|要记住他
WhenWearingAGarment1=表扬|(是) 对阿拉|谁|已经给与我穿上|这 (服装)|(3) x|为我提供|从|其他比|力量|(的) 我自己|不能
WhenWearingANewGarment1=O 真主|给你|(是) 好评|您|给我穿上|我问你|对于|其善|与善良|什么|取得了|为它|我寻求保护|和你一起|从|它的邪恶|与恶|什么|取得了|为它
WhileAscendingOrDescending1=同时提升或 Descending1 字
WhileBowingInPrayer1=荣耀|向我的主|崇高。
WhileBowingInPrayer2=荣耀是给你，|O 真主，|我们的主，|和是你的赞美。|O 真主，|原谅|我。
WhileBowingInPrayer3=(给你)，荣耀|最圣洁 (是你)，|耶和华|天使的|和精神。
WhileBowingInPrayer4=O 真主，|给你|我鞠躬 (祈祷)|和你|我相信|和你|我已提交。|谦卑|在你面前|我的听力是，|正如我的视线，|我的心，|我的骨头，|我的神经|和什么|已安装|后 (旅费)|我的脚。
WhileBowingInPrayer5=荣耀是给你，|母版|权力，|统治，|威严的|和伟大。
WhileProstrating3=虽然 Prostrating3 字
WhileProstrating4=虽然 Prostrating4 字
WhileProstrating5=虽然 Prostrating5 字
WhileProstrating6=虽然 Prostrating6 字
WhileProstrating7=虽然 Prostrating7 字
WhileReturningFromTravel1=同时从 Travel1 返回字
Whispers=字对字的低语
Whistling=吹口哨字
WhoeverMemorizesThemWillEnterParadise=谁能够记住这些将会进入天堂字
WiseOne=智者一词对词
WithDivineSuccessInExam=在考试词对词的神圣成功
WithDivineSuccess=与神圣成功字
Word=词字
WorshipOfMeditation=冥想词对词的崇拜
YaasirBinAmir=亚斌 Amir 字
YearlyPredestination=每年缘分字
YehBarreeWithHamzaAbove=带上喉塞逐字逐句 Yeh Barree
YehBarree=Yeh Barree 字
YehWithHamzaAbove=字一个字喉塞 Yeh
ZaydBinThaabit=Zayd Bin Thaabit 字
ZaynabBintiMuhammad=宾蒂默罕默德赞词对词
ZaynabBintJahsh=赞 · 宾特 · 哈士字
ZaynabBintKhuzayma=赞 · 宾特 · Khuzayma 字
WhileProstrating1=虽然 Prostrating1 字
Sham=深水字
PausingHamza=暂停喉塞音符词对词
GeneralAndSpecific=一般和具体词的词
SourcesOfAwareness=认识字的来源
HypotheticalJurisprudence=假设性判例字
AbuAmrBinAlAlaa=Abu Amr Bin 阿尔阿拉字
IbnKatheer=伊本 · 凯西尔字
Naafi=Naafi 字
IbnAamir=伊本 · 阿米尔字
Aasim=绥字
Hamza=喉塞音符词对词
AlKisaaee=Al Kisaaee 字
AbuJafar=阿布 · 贾法尔字
Yaqoob=雅各布字
Khalaf=卡拉夫字
Warsh=许字
Hafs=哈夫斯字
TheGreatQuran=伟大的古兰经 》 词对词
TheWiseQuran=明智的古兰经 》 词对词
TheGloriousQuran=尊贵的古兰经字
TheQuranFullOfReminder=古兰经 》 充满了提醒字
AClearQuran=明确的古兰经 》 词对词
ANobleQuran=高贵的古兰经 》 词对词
AGloriousQuran=尊贵的古兰经字
LordOfTheWorlds=世界词对词的主
LordOfEverything=一切字对字的主
LordOfMosesAndAaron=Moses 和亚伦字之主
LordOfAaronAndMoses=亚伦和 Moses 字之主
LordOfTheThrone=— 宝座词对词的主
LordOfTheNobleThrone=— 崇高的宝座词对词的主
LordOfTheGreatThrone=大宝座词对词的主
LordOfTheHeavensAndTheEarth=上帝的天堂和地球字
LordOfTheHeavensAndTheEarthAndWhatIsBetweenThem=上帝的天堂和地球和什么是他们字之间
LordOfYourFirstForefathers=你的第一列祖词对词的主
LordOfTheEastAndTheWest=东部和西部词对词之主
LordOfAllRisingsAndSettings=所有村级和设置字之主
LordOfEachPointOfSunrise=每一个日出点字对字的上主
LordOfThisCity=这座城市词对词的主
LordOfHonor=荣誉词对词的主
LordOfTheHeavens=耶和华天上字
LordOfTheEarth=地球词对词的主
LordOfSirius=天狼星词对词的主
LordOfTheTwoEasts=两方字对字的上主
LordOfTheTwoWests=两个西方词对词的主
LordOfThisHouse=这房子词对词的主人
LordOfDaybreak=黎明字对字的上主
LordOfMankind=人类词对词的主
LordOfTheSevenHeavens=耶和华七天上字
WorthyToBeFeared=值得让人害怕字
WorthyToForgive=值得原谅字
PeopleOfTheHouse=字对字的房子的人
PeopleOfAHouse=人民的房子字
PeopleOfTheMessage=字对字的消息的人
PeopleOfTheGospel=人们的福音字
PeopleOfMadinah=人民的麦地那字
PeopleOfATown=人民的 ATown 字
PeopleOfYathrib=人民的麦地那字
PeopleOfMadyan=人民的 Madyan 字
PeopleOfTheCities=人民的字对字的城市
PeopleOfThisTown=这个镇字对字的人
PeopleOfTheFire=人民的火字
CompanionsOfTheParadise=同伴们的字对字的天堂
CompanionsOfTheHappiness=同伴们的字对字的幸福
CompanionsOfTheRight=用词恰当的字眼的同伴
CompanionsOfTheElevations=字对字的海拔的同伴
CompanionsOfTheCave=字对字的洞穴的同伴
CompanionsOfTheSoundPath=声音路径词对词的同伴
CompanionsOfTheShip=同伴们的字对字的船
CompanionsOfTheFire=字对字的火狱的居民
CompanionsOfTheHell=同伴们的字对字的地狱
CompanionsOfTheSabbath=安息日字的同伴
CompanionsOfThePessimist=悲观主义者词对词的同伴
CompanionsOfTheLeft=字对字的左边的同伴
CompanionsOfTheBlaze=字对字的大火的同伴
CompanionsOfThePit=字对字的坑的同伴
CompanionsOfTheElephant=字对字的大象的同伴
CompanionsOfMadyan=Madyan 词对词的同伴
CompanionsOfTheThicket=字对字的灌木丛的同伴
CompanionsOfTheRock=字对字的岩石的同伴
CompanionsOfTheWell=井字一个字的同伴
CompanionsOfTheCity=城市词对词的同伴
CompanionsOfTheGrave=字对字的坟墓的同伴
CompanionsOfMusa=穆萨词对词的同伴
WhispererWhoWithdraws=教唆者的毒害字
BlowerInKnots=鼓风机在结字
RelatedNarrationBasedExegesis=相关的叙述基于训诂词对词
Remembrance3=Remembrance3 字
Remembrance4=Remembrance4 字
Remembrance5=Remembrance5 字
Thuwaybah=Thuwaybah 字
HalimahAlSadiyah=Halimah Al Sadiyah 字
ProperName=正确的名称字
ImperativeVerbalNoun=命令式语言名词字
RelativeDescriptivePronoun=相对描述性代词字
PointingDemonstrativePronoun=指代词字
ParticleOfPlaceAdverb=粒子的地方副词字
ParticleOfTimeAdverb=时间副词词对词的粒子
AccusativeParticle=宾格助词字
PossessionParticlePreposition=藏有粒子介词词对词
PossessionParticlesPrepositions=藏有粒子介词词对词
NegativeParticle=负电粒子字
ConditionalParticle=有条件的粒子字
InterrogativeParticle=字对字的疑问语气词
AnswerParticle=答案粒子字
CoordinatingConjunction=并列连词字
SubordinatingConjunction=从属连词字
AmendmentParticle=修订粒子字
AversionParticle=厌恶粒子字
ParticleOfCause=粒子的字对字的原因
CertaintyParticle=确定性粒子字
CircumstantialParticle=旁证颗粒字
ComitativeParticle=Comitative 粒子字
EqualizationParticle=均等化粒子字
ExhortationParticle=劝勉粒子字
ExplanationParticle=解释粒子字
ExceptiveParticle=例外粒子字
FutureParticle=未来粒子字
InceptiveParticle=初婚粒子字
ParticleOfInterpretation=粒子的字对字的解释
PreventiveParticle=预防性粒子字
ProhibitionParticle=禁止粒子字
ResumptionParticle=恢复粒子字
RestrictionParticle=限制粒子字
RetractionParticle=回缩粒子字
ResultParticle=结果粒子字
SupplementalParticle=补充颗粒字
SurpriseParticle=惊喜粒子字
VocativeParticle=呼格粒子字
RelativeTimeNounsAccusativeNounIndicatingTimeWhenActionOccurs=行动发生时词对词的相对时间名词宾格的名词表示时间
RelativePlaceNounsAccusativeNounIndicatingPlaceWhereActionOccurs=行动发生词对词的相对的地方名词宾格的名词指示地方
ThirdPersonMasculine=第三人称阳性词对词
ThirdPersonFeminine=第三人称女性词的词
SecondPersonMasculine=第二人称男性词对词
SecondPersonFeminine=第二人称女性词的词
FirstPerson=第一个人字
ImperativeLaamPrefixNegativeCommand=必须 Laam 前缀负命令字
LaamOfEmphasisEmphaticLaamPrefix=Laam 重点强调 Laam 前缀词对词
ImperativeLaamPrefix=必须 Laam 前缀词对词
PurposeLaamPrefix=目的 Laam 前缀词对词
AlOfDefinitenessDeterminerPrefix=Al 的确定性限定词前缀词对词
BouncingMechanism=弹跳机理字
VowellessLaam=于 Laam 字
LengtheningDueToHamza=由于哈姆扎字对字的延长
LengtheningDueToSukun=由于苏坤逐字逐句延长
ConnectingSoftLengthening=连接软延长字
SecondarySoftLengthening=二次软延长字
LengtheningWithTwoCauses=有两个原因字对字的延长
PronounHeh=代词 Heh 词对词
TheRoundZero=圆形零字
TheStandingOblongZero=常设长圆形零字一个字
RelationshipInLikeness=相似词对词的关系
RelationshipInCloseness=在词对词的亲密关系
RelationshipInSameTypes=在同一类型字对字的关系
RelationshipInDifferentTypes=在不同类型字对字的关系
RulesForEmptyHamza=空喉塞音符词对词的规则
TheStopOnEndsOfWords=词字对字的两端站
TheWritingOfTheFemaleHa=女性写作词的词
WordsSpecificallyForTheHafsRecitation=专门为哈夫斯朗诵词对词的的词
FormationsOfDifferentlyVoweledLetters=不同路警字母词对词的形成
LetterCharacteristics=信特征词的词
ProstrationsOfReading=读字 prostrations
DeepestPartOfTongue=最深的舌字对字的部分
MiddleOfTongue=中间的字对字的舌头
EdgeOfTongue=边缘的舌字
TipOfTongue=词对词的舌尖
DeepestPartOfThroat=最深的喉咙字对字的部分
MiddleOfThroat=中间的字对字的喉咙
ClosestPartOfThroat=最近的喉咙字对字的一部分
TheOneWhoseHelpIsSought=一个为帮助寻求字一个字
ThingsWhichServeThePublicInterest=逐字逐句地合乎公众利益的事情
BlockingOfTheMeans=阻塞的字对字的手段
TheMostBeneficentTheMostMerciful=最仁慈最仁慈逐字逐句
TheMostMercifulTheOneWhoseHelpIsSought=最仁慈的帮助是寻求字一个字
TheMightyOneTheGreatForgiver=强大的一个伟大的宽恕词的词
TheMightyOneTheBountifulOne=大能者的丰富的一个词的词
TheMightyOneTheAllCompelling=强大的一个字都令人信服一个字
TheClementOneTheGuideToPathOfRectitude=克莱门特的一个背离正道指南词的词
TheEmbodimentOfTruthTheClear=明确逐字逐句真理的化身
TheMostSacredTheEmbodimentOfPeace=最神圣和平的化身词的词
TheMostSacredTheMightyOne=最神圣的强大的一个词的词
TheEmbodimentOfPeaceTheInfuserOfFaith=和平的信念字对字的输液器的化身
TheInfuserOfFaithThePreserverOfSafety=信仰的保护者安全词对词的输液器
ThePreserverOfSafetyTheMightyOne=保护者的安全强大一词对词
TheAllCompellingTheDominantOne=所有令人信服的占主导地位的一个字
TheProtectingAssociateTheSoleLaudableOne=唯一值得称赞一词对词保护副教授
TheGreatOneTheExtremelyExaltedOne=大一的极其崇高的一个词的词
TheCreatorTheEvolver=造物主字对字的进化
TheEvolverTheFlawlessShaper=完美的牛头刨床字对字的进化
AndToYouAllMasculine=你所有男性词对词
AndToYouAllFeminine=你所有女性词的词
AndToYouBoth=给你两个字的词
AndToYouMasculine=男性词对词
AndToYouFeminine=女性词的词
TheNobleThrone=高贵的宝座字
TheGreatThrone=大宝座字
DisjointedLettersQuranicInitials=古兰经 》 首字母缩写脱节的字母词对词
SaleWithBuyBackContract=销售与回购契约字
TradingOfDebt=交易的债务字
ExchangeContracts=交换合同字
InterestInExchangeContracts=利息交换合同字
InterestInLoanContracts=贷款合同字对字的兴趣
ExcessiveMajorUncertainty=过大的不确定性字
MinorTolerableTrivialUncertainty=未成年人可以忍受琐碎不确定性字
AlefSakinaWithFathaBeforeIt=Alef Sakina 与罚前字的骂
WawSakinaWithDammaBeforeIt=Waw Sakina 与前字 Damma
YehSakinaWithKasraBeforeIt=叶萨金娜与前字 Kasra
WawWithoutLengthening=没有延长字 waw
YehWithoutLengthening=叶没有延长字
TwoLipsFromInside=从内部字一个字的两片嘴唇
UnderTheDeepestPartOfTongue=根据舌字对字的最深的部分
EdgeOfTongueLowestPart=舌头最低部分字对字的边缘
UnderTipOfTongue=根据提示词对词的舌头
CloseToUnderTipOfTongueWithTop=根据与顶部字对字的舌尖靠近
TipOfTongueLetters=尖端的舌头字母词的词
GumLetters=口香糖字母词的词
ElevatedGumLetters=高架的胶字母词的词
TipLetters=提示词对词的字母
AajurroomiyyahChapter1=文本|Aajurroomeeyah|in|语法|说|作者|可能对他的怜悯|真主:|种类|演讲|有用的声音:|它是|表达式/话语|加上，|有意义|在其句法的序列。|它唯一的零件组成的|第三:|名词，|动词，|与颗粒|来|与意义/意义。|然后名词|众所周知，|由于代理 kasra 表达式|和 noonation，|和进入|阿勒夫|和醋|在其上，|和字母|由于代理 kasra 的表达|和他们是|从|而至，|和约，|及后，|和，|而以，|和 baa，|和 kaaf，|和醋，|和字母|誓言，|和他们是|waw，|和呸，|和 tah。
AajurroomiyyahChapter2=和动词|据悉，|与肯定，|见过，|并将|及 taa|女性气质|元音-少。|粒子|it|非|不接受|与它|适应证|名词的|而不是|适应证|名词。|门|拐点|拐点|它是:|它改变了|结局|词的|由区别|是活动元素摄政王|进入|在上面|表观|或者|假设。|和它的零件|有四个:|主格，|和宾格|和所有格，|与命令/斜案例、|然后为名词|从|那|主格，|和宾格|和所有格，|而不是|命令/斜案例|在它，|然后为动词|从|那|主格，|和宾格|与命令/斜案例、|而不是|所有格|在它。
AajurroomiyyahChapter3=章节|第一个|标志|拐点/案件的结局|为主格|in|四|体征:|damma，|和 waw|和阿勒夫|到中午。|然后为|damma|然后它是|标志|为主格|in|四|职位:|名词|单个窗体，|和复数|坏了，|和复数|女性|声音，|和动词|存在|其中|什么也没有|附加与联系|与它的结局|所有的东西。|和|waw|然后是|标志|为主格|in|两种情况:|in|复数|男性|声音，|中和|名词|五、|和他们是:|你的父亲，|和你的兄弟，|和你的公公，|和你的嘴，|和拥有化学武器的国家|财富。|和|阿勒夫|然后是|标志|为主格|in|双|名词|特别。
AajurroomiyyahChapter4=和|中午|然后是|签名|为主格|in|动词|目前，|当|连接的|与它|代词|二元性|或者|代词|所述多个，|或者|代词|女性气质|每秒处理的人。|宾格|五|标志|罚的骂，|和阿勒夫|和 kasra，|和呀，|和删除|中午。|然后为|罚的骂|然后是|标志|为宾格|in|三|例:|in|名词|奇异，|和复数|坏了，|和动词|现在时态|当|输入|到它|虚拟语气的情况下，|并没有|连接的|与它的结局|所有的东西。|和|阿勒夫|然后是|标志|为宾格|in|名词|五、|就像:|(我见过|你的父亲|和你的兄弟)|和什么|类似|那。
AajurroomiyyahChapter5=和|kasra|然后是|标志|为宾格|in|复数|女性|声音。|和|是啊|然后是|标志|为宾格|in|双|和复数形式。|和|删除|中午的|然后是|标志|为宾格|in|动词|五|其中|它主格|与恒常性|中午。|所有格|三|体征:|kasra，|和呀，|和罚的骂。|然后为|kasra|然后是|标志|为所有格|in|三|例:|in|名词|单数|完全屈折，|和复数|破碎|完全屈折，|中和|复数|女性气质|声音。|和|是啊|然后是|标志|为所有格|in|三|例:|in|名词|五、|中和|二元性|和复数形式。
AajurroomiyyahChapter6=和|罚的骂|然后是|标志|为所有格|in|名词|其中|非|完全屈折变化。|其命令的理由|两个标志:|苏坤|和删除。|然后为|苏坤|然后它是|标志|命令的理由|in|动词|存在|声音|结束。|和|删除|它是|标志|为命令|in|动词|存在|弱|结局|中和|动词|五|其中|它指示|切除|中午。|分区|屈折变化|屈折变化|分为两个部分:|部分|屈折变化|与元音的迹象，|和部分|屈折变化|用字母。
AajurroomiyyahChapter7=然后，|屈折变化|与元音迹象|四|事情:|名词|奇异，|和复数|破碎的|和复数|女性|声音，|和动词|现在时态|其中|非|已连接|与它的结局|所有的东西。|和他们每个人都|由主格|与 damma，|和做宾格|与罚的骂，|和做的所有格|与 kasra，|和作出的命令|与苏坤，|和失散|从|那|三|事情:|复数形式|女性气质|声音|作宾格|与 kasra，|和名词|其中|非|充分 inflectable|是由所有格|与罚的骂，|和动词|存在|连接的|它的结局|命令|与删除|它的结局。|而|反映|用字母|四|类型:|双，|和复数|男子气概|声音，|和名词|五、|和动词|五、|和他们是:|他们两个男性做，|和他们两个女性你们两个做|他们所有男性这样做，|所有男性的你，|和女性的你。
AajurroomiyyahChapter8=然后为|二元性|然后你让主格|alef|你让宾格|和使所有格|与严。|和|复数|男子气概|声音|然后它使主格|带有 waw|和使宾格|和使所有格|与严。|和|名词|五|然后它使主格|带有 waw，|和使宾格|alef，|和使所有格|与严。|和|动词|五|然后它使陈述语气|中午，与|和使虚拟语气|和使命令心情|删除它。|这一章|动词的|动词|有三个:|过去时态，|和现在时态|和命令紧张|就像:|他打了，|和他打吗，|和命中。|过去时态:|与罚的骂|结局|总是，|和命令紧张|命令|始终。
AajurroomiyyahChapter9=和现在时态|什么|was|in|它的第一|一|增加的内容|四|其中|当加入到它的时候|你可以说:|(tah、 中午、 阎喉塞音符)|它是|主格|总是，|直到|进入|在上面|虚拟语气|或者|命令。|然后 subjunctiveness|十年|和他们是:|到那，|和永远不会 / 不会|和那时/因此，|并且，为了到所以，|和林|因此|和林|逃税行为，|和直到/达，|和一个句子的响应，结论，扼要子句|与发|和 waw|和或。|和命令|八|十、|和他们是:|没有，|并不是什么，|也没有，|和什么不一样，|和林|命令|和恳求，|并且|(不做)|in|禁止|和恳求，|和，如果，|和什么，|和谁，|无论，|每当 / 如果|什么，|而，|时候，|在哪里|和下落，|和这样，|何地，|然而，|和那时/因此|in|诗歌|具体。
AajurroomiyyahChapter10=章节|主格例的|名词的|主格例|7、|和他们是:|活跃的元素，|和对象|其中|非|一直叫|它的主题，|问题，|和谓语，|和的名词|(是) / 动词是|和它的姐妹，|和的谓词|(当然) / 宾格粒子|和它的姐妹，|和追随者|主格的|它是|四|事情:|形容词，|和一起，|并强调，|和替代。|这一章|活动元素的|活动元素|它是:|名词，|主格，|一提|在它之前|其动词。|它是|upon|两个部分:|很明显，|和隐藏，|然后明显|就像|你说:|站在|宰，|和站|宰，|和站在那里|两个 Zayds，|和站|两个 Zayds，|和站在那里|Zayds，|和站|Zayds，|和站在那里|男人，|和站|男人，|和站在那里
AajurroomiyyahChapter11=后腿，|和站|后腿，|和站在那里|两个海因兹，|和站|两个海因兹，|和站在那里|不要惊动，|和站|不要惊动，|和站在那里|不要惊动，|和站|不要惊动，|和站在那里|你的兄弟，|和站|你的兄弟，|和站在那里|小男孩奴隶|和站|小男孩奴隶|和什么|是类似于|那。|隐藏|是两个|十、|就像|你说:|(我打，|和我们打，|和你阳刚打，|和你女性的命中，|和你两个打，|和你所有男性打，|和你所有女性打，|和他打了，|和她打，|和他们两个打，|和他们阳刚打，|和他们女性打)。|章节|外力|其中|没有|呼叫|其积极的元素|和它是:|名词，|主格，|其中|没有|提及|与它|其积极的元素。|然后如果|was|动词|过去时态|把 damma|第一|把 kasra|什么|之前|其结局/倒数第二|如果|was|现在时态|把 damma|第一|把罚的骂|什么|之前|其结局/倒数第二。
AajurroomiyyahChapter12=它是|upon|两个部门:|很明显，|和隐藏;|然后明显|就像|你说:|(被殴打/点击|扎伊德)|并且|(是殴打/点击|扎伊德)|并且|(荣获|) Amr|并且|(是荣幸|Amr)。|隐藏|二|十、|就像|你说:|(我是殴打/命中，|和我们被殴打/命中，|和你男性被殴打/命中，|和你女性被殴打/命中，|你们俩殴打/命中，|和你所有男性被殴打/命中，|和你所有女性被殴打/命中，|和他被殴打/命中，|和她被殴打/命中，|两人殴打/命中，|和他们男性被殴打/命中，|和他们女性被殴打/命中)。|(章|主题|和谓词)|主题:|它是|名词|主格|空闲|从|原因/因素/主动元素|口头表达 /|和谓词:|它是|名词|主格|依赖项|到它，|就像|你说:|(宰|是站)|并且|(两个 Zayds|站)|并且|(Zayds|站)。
AajurroomiyyahChapter13=和主题|有两个部分:|很明显，|和隐藏;|然后明显|什么|来之前|其一提，|隐藏|二|十、|和他们是:|我，|我们，|你阳刚，|你女性，|你们两个，|你所有男性，|你所有的女性，|他，|她，|他们两个，|他们阳刚，|他们女性，|就像|你说:|(I|我站|和我们|站)|和什么|是类似于|那。|和谓词|有两个部分:|单数;|和其他比|奇异，|然后是单数|就像:|(宰|是站)|和其他比|单数|四|事情:|介词|和它支配这个词在所有格形式，|和间接言语名词，|和动词|带有|其积极的元素，|和主题|带有|其谓语|就像|你说:|(宰|在|房子，|和 Zayd|就在附近/你，|和 Zayd|是站|他的父亲，|和 Zayd|他女性的奴隶/阿比盖尔|去)。
AajurroomiyyahChapter14=这一章|功能/元素/致使概念|进入|upon|主题|和谓词|和他们是|三|事情:|动词是|和它的姐妹，|和宾格粒子当然可以|和它的姐妹，|我想|和它的姐妹。|然后为|be/(was) 对动词|和它的姐妹，|然后当然它|使得主格|名词，|和使宾格|谓词，|和他们是:|动词是，|和它在夜晚，成为了|和它变成 / 早晨，成为|和它在那天上午，成为了|和他保持的所成为的|和它在夜晚成为了/他花留夜/一夜之间，|它变成了，|而不是|还有 (继续)|他是|并不是保持|他是停止某事，|和不/不断|他是停止某事，|和仍然/继续|他是|而且只要|他剩余，|和什么|推导出|从他们|就像:|他是，|他是|和，|和他成为了/它成为了早晨，|和他成为/它变得早晨，|成为 (上午)|你说:|(是|宰|站，|并不是|Amr|凝视着/看了一眼眼中)|和什么|是类似|到那。|和|当然宾/粒子|和它的姐妹|然后当然它|让宾格|名词|和使主格|谓词，|和他们是:|当然/的确/实在，|而且，|但是，|好像，|希望 / 如果只，|也许，|你说:|实在|扎伊德|站，|我希望|Amr|被盯着看的所凝视的
AajurroomiyyahChapter15=和什么|类似|到它，|和意义|肯定|和那|强调，|但|为校正/整改/对供应的是缺掉的|因为如果|相比之下，|和想要是|祝福，|也许|希望|和期望。|和|我思想双宾动词|和它的姐妹|然后当然它|让宾格|主题|和谓词|upon|那两个|采取行动|对他们来说，|和他们是:|我思想/相信/认为，|和我思想/相信/认为，|和我思想/相信/认为，|和我思想/相信/认为，|我知道，|我知道，|而我发现，|和我了，|和我做了，|并听取了;|你说:|我以为|宰|站起来了，|我看见|Amr|凝视所看，|和什么|是类似|到那。|(章|形容词)|形容词:|一个追随者|被描述的词|in|它主格|和其宾格|和它的所有格，|和确定性|和不确定性;|你说|站在|宰|智能，|我看见|宰|智能，|和我通过|由扎伊|智能化。
AajurroomiyyahChapter16=确定性|五|事情:|名词|隐含的代名词形式|就像:|I|和你，|和名词|正确|就像:|宰|和麦加，|和名词|模糊/不清楚/示范|就像:|这个男性|和这个女性|而这些，|和名词|其中|在它|阿利夫|和林|就像:|男子|和那个男孩，|和什么|附加|到|一|从|这些|四。|和不确定:|每隔|名词|一般/常用|in|其性别|非|指定|与它|一|无|其他，|和其密切的理解:|全部|那|使用|条目|alef 的|和林|在其上，|就像|男子|和那匹马。|章节|结合|和颗粒|结合|十年|和他们是:|waw /，|和美国联邦航空局/和/所以/那时，|和那时/下一步，|或，|或，|或者，|但是，|而不是，|但是，|直到|in|某些|地方。
AajurroomiyyahChapter17=然后如果|被连体|与它|upon|主格案例/指示心情|这将是主格案例/指示心情，|或者|upon|宾格案件语气|它将是宾格的案例/虚拟语气，|或者|upon|所有格|这将是所有格，|或者|upon|命令的心情|它将命令的心情，|你说:|(站在|宰|和 Amr，|我看见|宰|和 Amr，|和我通过|由扎伊|和 Amr，|与扎伊|没有|柜|也没有|坐)。|这一章|强化重点/同位语的|重点:|(一个追随者|为强调明确的词|in|它主格|和其宾格|和其所有格|和其确定性)。|和是|与表达式|特定，|和他们是:|自我，|和自我/相同，|和每个/一切，|和整个/整体/一切，|和追随者|复数/整个/整体/一切，|和他们是:|所有/一共/整体/全缘，|和所有/一共/整体/全缘，|和所有/一共/整体/全缘，|你说:|站在|宰|自己，|我看见|人民|所有的人，|与我擦肩而过|人民|所有。
AajurroomiyyahChapter18=这一章|替代的|当|我替换|一个名词|从|一个名词|或者|一个动词|从|一个动词|它遵循|in|全部|它的拐点。|它是|upon|四|部件:|替代/更换|东西|从|东西，|和替代|某些部分|从|整体，|和替代|安全壳/包容性|和替代|不正确/错误，|就像|你说:|(站在|宰|你的兄弟，|我就吃了|一卷/条面包|第三，|和给我带来好处|扎伊德|他的知识，|我看见|扎伊德|马)，|你想要|那|你说的|我看见|那匹马|然后以犯错误以为|然后代|扎伊德|从它。|章节|接动名词做宾语的|名词的|接动名词做宾语|五|十、|和他们是:|所作所为后|通过它，|和不定式|和副词|时间，|和副词|地方，|和条件，
AajurroomiyyahChapter19=和规格，|和除外/排除在外，|和名词|不，|和呼格的名词，|并采取行动 / 对象|对于|为了它，|并采取行动 / 对象|伴随着它，|和谓词|动词，是的|和它的姐妹，|和名词|当然宾/粒子的|和它的姐妹，|和追随者|为宾格|和他们是|四|事情:|形容词，|和一起，|并强调，|和替代。|章节|对象/行事|由它|和它是:|名词，|宾格|其中|位于|在上面|动词，|就像|我打节拍击中|扎伊德，|我骑|那匹马。|它是|两个部分:|明显的/名词，|并暗示/代词;|然后明显|非|开始|它的提及，|和默示|两个部分:|附加，|和失散，|金及附加|是两个|十、|和他们是:|他命中/击败我，|和他命中/击败我们，|和他命中/击败你阳刚，|和他命中/击败你女性，|和他命中/击败你们两个，|和他命中/击败你所有男性，
AajurroomiyyahChapter20=和他命中/击败你所有女性，|和他命中/击败他，|和他命中/击败她，|和他命中/击败他们两个，|和他命中/击败他们阳刚，|和他命中/击败他们女性。|和失散|是两个|十、|和他们是:|我，|而我们，|和你阳刚，|和你的女性，|还有你们两个，|和你所有男性，|和你所有女性，|和他，|和她，|和他们两个，|和他们的男子气概，|和他们的女性。|章节|不定式的|动词不定式|它是:|名词，|宾格|其中|来自|第三个|in|共轭|动词，|就像:|他打了，|他打了，|打。|它是|两个部分:|发音/言语，|而语义/方面的意义，|然后如果|同意|它的发音|发音|其动词的|然后它是|发音/言语，|就像:|杀了他|杀戮/致命，|如果|同意|意义|其动词的|无|其送电|然后它是|语义/有关的意思，|就像:|我坐在|坐在上下，|和我站在|一个站/向上/高高的|和什么|是类似于|那。
AajurroomiyyahChapter21=章节|对副词|时间，|与副词|地方|副词|时间|它是:|一个名词|时间|宾格|与暗示|(中)|就像|一天，|夜晚，|清晨，|清晨，|和前一天休息的时间|今明两天，|深夜人的第一第三|到了中午，午夜|和晚上，|和永远/总是/无止境的|和很长的时间，|和一些时间。|和什么|是类似于|那。|与副词|地方|它是:|一个名词|地方|宾格|与暗示|(在)，|就像:|前面，|和隐藏，|和前面的|和隐藏，|及以上，|及以下，|与在/由/，|和对面/面对/脸去面对，|和对面/面对/脸去面对，|和前面的|和那里/在那边，|然后，|在这里，|和什么|是类似于|那。|(章|条件)|条件|等于:|名词，|宾格|解释|为此，|是模糊/模糊/可疑|从|条件时|就像|你说:|(来了|宰|骑马)|并且|(我骑
AajurroomiyyahChapter22=那匹马|它胜过一切)|并且|(我见过|仆人|真主|骑马)|和什么|是类似于|那。|而不是| Yin|条件|除了|无限期，|而不是| Yin|除了|之后|完成|演讲中，|而不是| Yin|其助理/追随者|除了|明确。|这一章|规范的|规格|它是:|名词，|宾格的情况下，|解释|为此，|不清楚|从|精华，|就像|你说:|(滴|扎伊德|汗水)|并且|(爆炸爆裂 /|巴克尔|在脂肪)|并且|(是好|默罕默德|人)|并且|(我买了|二十|书)|并且|(我拥有|九十岁|羊羊/女)|并且|(宰|是更光荣/高贵|比你|作为一位父亲)|并且|(他是更美丽|比你|在面部外观/外观)。|而不是| Yin|除了|无限期，|而不是| Yin|除了|之后|完成|讲话。
AajurroomiyyahChapter23=这一章|异常/驱逐的|和颗粒|异常的|八项，|和他们是:|除外，|和其他比，|除了 / 其他比/与不同的是，|除了 / 其他比/与不同的是，|以及是否，|除了分开从|除了分开从|除了分开从。|然后除外|通过除外|让宾格|当|was|这次演讲|完成|积极，|就像:|(以发言|人民|除了|扎伊德)|并且|(左|人民|除了|) Amr|如果|was|这次演讲|负|完成|允许允许的话|在它|替代|宾格|upon|例外，|就像:|(不|站在|人民|除了|扎伊德)|并且|(除外|扎伊德)|如果|was|这次演讲|不完整|was|upon|根据|功能/因素，|就像:|(不|站在|除了|扎伊德)|并且|(不|我击中/击/击败|除了|扎伊德)|并且|(不|我通过|除了|由扎伊德)。|和异常|与/除以外，与不同的是，|除了 / 其他比/与不同的是，|除了 / 其他比/与不同的是，|和其他比|所有格|非|其他。
AajurroomiyyahChapter24=和异常|与除分开从|除了分开从|除了分开从|它允许|其宾格|和它的所有格，|就像:|(站在|人民|除了|扎伊德，|与扎伊)|并且|(除外|Amr|和 Amr)，|并且|(除外|巴克尔|和巴克尔)。|第章|(没有)|知道|那|(没有)|让宾格|无限期|与其他比|noonation|If|之间的自然数|无限期|也没有|重复|(没有)|就像|(没有|人员|in|那所房子)。|然后如果|没有|后立即来|需要|主格|和需要|重复|(没有)|就像:|(不|in|这房子|一个男人|也不是|一个女人)|然后如果|被重复|(没有)|它是允许有|它的功能|以及它的撤销，|然后如果|你想要|你说:|(没有|人员|in|这房子|也不是|女人)。
AajurroomiyyahChapter25=这一章|呼格的|呼格|五|类型:|单数|专有名词，|与不确定性|已知或意欲，|与不确定性|其他比|已知或意欲，|和附加/拥有，|和类似|与附加/拥有。|然后为|单数|专有名词，|与不确定性|目的|然后都是结构|upon|damma|从|其他比|noonation，|就像|(O) Zaid|并且|(啊)|和三个|剩余|宾格|否|其他。|章节|对象/行事|从|成因的缘故|和它是:|名词，|宾格|其中|提到我的|解释|原因|发生|行动，|就像|你说:|(站在|扎伊德|出于尊重|为 Amr)|并且|(我来找你|渴望|那对你有好处)。
AajurroomiyyahChapter26=章节|对象/行事|与它 / 伴奏|和它是:|名词，|宾格的情况下，|其中|被提及|与指定|从|谁是做对|与它|行动，|就像|你说:|(来了|领袖|与军队)|并且|(成为水平|水|用木头)。|和|谓词的|(是) / 动词是|和它的姐妹|和的名词|(当然/的确) / 宾格粒子|和它的姐妹|然后当然|来之前|提到的两个|in|nominatives，|和像那样|追随者;|当然|来之前|那里。|这一章|属格结构的|从|名词|属格结构|有三个|种类:|所有格|与粒子介词|和所有格|与附件/藏建设，|和追随者|所有格。|和|所有格|与介词/颗粒|然后是:|什么|是由所有格|通过从，|和到/对，|和从，|及后，|和，|和一些/许多/也许，|和呸，|和 kaf，
AajurroomiyyahChapter27=和林|和之前的粒子的介词|誓词 》:，|和他们是:|waw|和呸，|和 tah，|和以 waw|可能，|和与以来，|和自 / 前。|和|这其中|使得所有格|与附件/藏建设，|然后就像|你说:|(男孩和仆人|扎伊德) 的|它是|upon|两个部分:|这其中|被暗示|与林，|和什么|被暗示|与从;|和那个的|被暗示|与林|就像|(男孩和仆人|扎伊德) 的|和那个的|被暗示|与从，|就像|(服装|丝绸)|并且|(一扇门|铁片)|并且|(环|铁)。|已完成|与所有的赞美和感谢|向安拉。
GreatMasterpieceCover=杰作|很好。|与解释|介绍|Aajurroomiyyah。
GreatMasterpieceIntro=在名称中|真主|最仁慈|最仁慈。|所有的赞美|是对阿拉
GreatMasterpiece1=介绍:|定义|语法，|它是一门学科，|它的好处，|它有之前起源的关系|和一位作家，|裁决|伊斯兰法|在它。|定义:|意义|(的语法)|引用位置|in|语言|阿拉伯语的|打开|多|含义:|从它|方向，|它说:|我去了|在的方向|任何人|即:|它的方向。|并从它|类似|和类似，|它说:|默罕默德|看起来像|阿里，|即:|它是类似|和它是一样。|是指|意义|语法|in|术语|科学家|打开|(知道|规则 》|其中|让人理解|与它|裁决|结尾的|字|阿拉伯语|in|箱子|它是建设:|从|词形变化，|和结构|和什么|如下|那)。|主题:|主题|知识|语法:|单词|阿拉伯语|从|方向|搜索|对于|雕像|提到。|好处:|效益|研究|知识|语法:|保护|舌头的|从|错误|in|这次演讲|阿拉伯语|和理解|古兰经 》|高尚|和传输|预言|和理解|真实，|这两个，|的|基础|法律|伊斯兰|在这两个|他们的中心。|创始人:|它是|从|规则 》|阿拉伯语。|第一作者:|和众所周知|那|第一|要把|知识|语法|他是|父亲|黑色的|Du'alee，|由命令|指挥官的|忠实的|阿里|儿子|父亲|布|很高兴|可以阿拉|与他。|这项裁决|伊斯兰法|在它|和学习它|是一项义务|从|义务|集体、|也许|指定|要了解|upon|一个人|它变得|义务|个人的|身上。
GreatMasterpiece2=量的名称|真主|最仁慈|最仁慈。|说|工作簿:|他是|父亲|仆人|真主|儿子|默罕默德|儿子|David|Sanhaajah|著名|为儿子|Aajurroom。|他就此诞生|in|年|672|二|和 70|和六百年|他死了|in|年|723|三|和二十|七百名|从|移民|预言|-|对他的怜悯|真主|最高。|它说:|这次演讲|它是|表达式|组成的化合物|有用意义|把在阿拉伯语语言。|我说:|表达式的|(关于演讲)|两个含义/组成的:|其中之一|词汇/语言，|和第二个|语法。|通过|单词|语言|然后它是|短语|其中|获取|原因|一种福利，|是否|它是|一个表达式，|或者|非|它是|像线一样|和写作|和迹象或征兆|。|对于|语音|语法，|它是必要的|从|那|它满足了|在它|四|条件或物:|第一|那|他们是|表达，|和第二次|那|他们是|组成，|和第三个|那|他们是|有意义，|和第四次|那|他们是|主题|与方法|阿拉伯语。|含义|它被|表达式:|它|他们是|声音|非独占|upon|某些|字符|按字母顺序|其中|开始时间|alef|和结束|与阎|它就像|(Ahmad)|并且|(他写)|并且|快乐;|然后如果|每隔|一|从|那些|单词|三|具有|发音|与它|这将是|声音|非独占|upon|四|按字母顺序|信件:|然后，它是标志或征兆||喜欢|非|被听到|单词|依据|一位科学家;|为不|正在|声音|非独占|upon|某些|字符|如果|它是|听到|依据|语言学家|演讲;|要获得|福利|有了它。|和意义|正在|组成:|那|他们是|组成|在|两个字|或者|更多，|如:|(默罕默德|是一个旅行者)|并且|(知识|是有益的)|并且|(达到|努力工作|区别)|并且|(为每个|勤奋的人|是的奖励)|并且|(知识|是更好|什么|努力|它)|然后每个|句子|从|那些|句子|我们叫它|演讲中，|和每个|句子|从它|组成|在|两个字|或者|更多，|然后 word|一|不是|被称为|语音|依据|语法学家|除了|当|加入|其他比它|到它|If|它是|加入|其他比它|到它|在这一事实|如示例所示|事先，|或者|言外之意，|正如|当|说|给你|某人:|那是|你的哥哥吗?|然后它说，|默罕默德|因此|单词|被认为是|演讲中，|因此|它意味着:|默罕默德|是我的兄弟:|然后它是|in|含义|这句话|组成|在|三|单词。|和意义|正在|有意义:|那|它会更好|沉默|演讲者|对此，|在其中|非|仍然是|侦听器|正在等待|对的事情|最后，|然后如果|我说话|(当|来自|老师)|非|它被称为|那|演讲中，|如果|那|表达式|组成|从|三|词;|这样，|说话的人|等待|什么|他会说|之后|此|其中|会的结果|upon|到来|老师。|然后当|我说:|(当|来自|老师|将听|学生)|最愉快的是|这次演讲|要获得|由于采集的意义中获益。|和意义|正在|主题|用的语言|阿拉伯语：|那|的|表达式|已使用|in|语音|从|表达式|其中|坐|阿拉伯语|为符号|打开|意义|从|意义|喜欢|(他出席)|Word|它是语言|阿拉伯语|意义，|它是|发生|出勤|in|时间|过去，|一个字|(穆罕默德)|当然|它是语言|阿拉伯语|意义，|它是|个人|特别是的|被称为|由那|名称，|然后当|是说|(出席|默罕默德)|它是|当然|已使用|两个字|全部|从他们|从什么|它是语言|阿拉伯语|如反对|什么|当|口语|用一个词|从什么|一种语言|非阿拉伯人:|像波斯人，|和土耳其人，|和柏柏尔人，|和法兰克人，|然后当然是|非|被称为|in|使用情况|科学家们的|阿拉伯语|演讲中，|即使|它是由调用|人民|语言|其他|讲话。|示例|演讲|实现|条件:|天气|是清楚的。|花园里|是卓有成效的。|新月|是光明的。|天空|是晴朗无云。|灯|月亮|在晚上。|后于|勤劳的工作者。|非|将繁荣|懒惰的人。|没有|受崇拜的权利|除了|真主。|穆罕默德是|最好的|使者。|真主|是我们的主。|默罕默德|是我们的先知。|一些例子|表达式|一个字:|默罕默德。|阿里。|亚伯拉罕。|他站在。|从。|一些例子|组成|没有被|有意义:|城市|亚历山德里亚。|仆人|真主。|哈德拉毛。|If|只是|人。|当|来自|冬天。|无论|隐藏|两个面临。|If|上升|太阳。|问题|打开|什么|提供了|此培训完成后，受众能够做些什么?| Yin|演讲吗?|此培训完成后，受众能够做些什么?|意义|正在|表达吗?|此培训完成后，受众能够做些什么?|意义|正在|作文吗?|此培训完成后，受众能够做些什么?|意义|正在|有意义吗?|此培训完成后，受众能够做些什么?|意义|正在|主题|与语言|阿拉伯语？|做例子|五|示例|为什么|被称为|带有|定义|演讲。
GreatMasterpiece3=种类|演讲|它说:|它会解释|第三:|名词，|动词，|颗粒|来|意义。|我说:|表达式|其中|was|阿拉伯人|它所使用的|in|他们的话语|通过对传输|给我们|与他们|然后我们|讲话|与它|in|我们的对话|和我们的教训|我们读|in|我们的书|我们写|与它|到|我们的家庭|和我们的朋友，|非|发现/无|一|从它|带有|那| Yin|一|从|三|对象:|名词，|动词，|粒子。|对于|名词|in|语言|然后是:|什么|是指|到|已命名的|中和|术语|意义:|一个字|引用|到|意义|in|本身，|而不是|已连接|用一段时间，|就像:|默罕默德，|阿里|和男人，|和骆驼，|和河，|和苹果，|和一杯柠檬茶，|和棍子，|然后每个|一|从|这些|表达式|是指|到|意义|而不是|时间|进入|in|意思，|然后它是|一个名词。|和|动词，|它是|in|语言|事件|中和|术语|意义:|一个字|引用|到|意义|in|本身，|它连接|一个|次数|三|-|其中|它是|过去，|到现在，|和未来|-|就像|(他写了)|然后当然是|一个字|引用|到|意义|-|它是|正在写入|还|-|和那|意义|连接|与时间|过去，|就像|(他写)|然后当然是|引用|到|意义|-|它是|正在写入|还|-|和那|意义|连接|与时间|目前，|就像|(写)|然后当然是|一个字|引用|到|意义|-|它是|正在写入|还|-|和那|意义|连接|与时间|未来|这就是|之后|时间|说话。|和实例|这些|表达式:|他帮助的协助|他帮助助攻|并帮助或协助，|他明白|他也理解|和了解，|他知道|他知道|知道，|和他坐在那里|和他坐|而坐，|和他打|和他的命中|和命中。|和动词|upon|三|种类:|过去，|和现在的|和未来:|然后过去:|什么|是指|到|事件|该发生的事情发生的那次|in|时间|这就是|之前|时间|说话的|就像|他写道:|和他的理解，|他走了出去，|他听到，|他看见，|和他谈，|和他请求原谅，|和他参加/加入。|和现在:|什么|是指|到|事件|发生|in|时间|说话的|或者|在它以后|就像|他写道:|他也理解，|和他出去，|他听到，|他帮助的;|和他说话，|和他请求宽恕，|和他参与/联接。|与该命令:|什么|是指|到|事件|请求|它完成了|之后|时间|说话，|就像|写，|和了解，|出去，|听着，|和帮助，|和说话，|和请求宽恕，|和参与的联接。|和|粒子:|然后它是|in|语言:|边缘|中和|术语|意义:|一个字|引用|到|意义|in|其他比它，|就像|(从)，|然后当然|那|表达式|是一个词|引用|到|意义|-|它是|开始|-|和那|意义|非|已完成|直到|正在加入|到|那|Word|其他比它，|然后你说:|(我来|从|房子)|举个例子。|示例|名词:|书，|钢笔，|墨水瓶，|/ 小册子|报纸，|人/朋友，|义人，|伊姆兰，|纸页|食肉兽/动物，|驴，|狼，|猎豹，|老虎，|柠檬，|橙色，|梨，|水仙，|玫瑰，|这些，|你所有。|示例|动词:|他旅行|他旅行|旅行，|他说/分支|他说，讲话|说/说话，|他已经安全|他是安全的|是安全的|他已接受/高兴|他是接受感到高兴|接受/很高兴，|他一直诚实|他是真实的|说实话，|他一直努力|他工作努力|努力工作|他请求宽恕|他请求原谅|祈求宽恕。|示例|粒子:|从|到/朝/达不包括，|从怎么样，|对，|除了/除非/如果不是，|但/然而，|实在/真正/肯定，|对，|是的/事实上，|nay/宁愿/但/然而，|当然，|会，|直到，|不 / 没有，|有没有，|不 / 永远不会，|如果 / 不可能的事，|不但是/时，|也许可能是如此/说到|什么/这，|在未来，/|希望 / 如果只，|如果，|然后，|或。|问题|此培训完成后，受众能够做些什么?| Yin|名词吗?|给|该名词|十|例子。|此培训完成后，受众能够做些什么?| Yin|动词?|自|几个|部件|分段|动词?|此培训完成后，受众能够做些什么?| Yin|现在呢?|此培训完成后，受众能够做些什么?| Yin|该命令吗?|此培训完成后，受众能够做些什么?| Yin|过去吗?|给|为动词|十|例子。|此培训完成后，受众能够做些什么?| Yin|粒子?|给|为粒子|十|例子。
GreatMasterpiece4=标志|名词的|它说:|然后名词|据悉:|降低/占有/所有格例|和 noonation，|和进入|阿勒夫|laam，|和颗粒|财产/所有格的情况下，|和他们是:|从|到/朝/达不包括，|和从怎么样，|和上/时，|和，|也许 / 很多次了，|和呸，|和 kaaf，|和醋，|和颗粒|誓言，|和他们是:|waaw，|和呸，|和 tah。|我说:|该名词|标志|将其区分开来|从|它的兄弟|动词|与颗粒|存在|之一|从它|或者|同意它:|和肯定|提到|作者|-|对他仁慈|真主|-|从|这些|标志|四|迹象，|和他们是:|降低/占有/所有格的情况下，|noonation，|进入|阿勒夫|和醋，|和进入|一个粒子|从|颗粒|财产/所有格案例。|作为为|拥有/所有格案例|它是|in|语言:|反|殿下/海拔，|中和|术语|意义|引用|到|kasra|其中|造成的|功能/主动元素/摄政王|或者|这其中|争议|为它|和那|示例|kasra|raa 的|从|(巴克尔)|并且|() Amr|in|语法|你说:|(我通过|由巴克尔)|你说:|(即|是这本书|Amr)|然后巴克尔|和 Amr:|两个名词|与存在|kasra|in|结局|天|一|从他们。|至于|noonation|它是|in|语言:|发声，|你说:|(声音|一种鸟)|即:|声音/放弃某样东西的声音|中和|术语|意义|它是|中午|清楚|关注|结尾|这个词的|表达，|和它分离|直线|自-sufficient 吗不需要|从它|重复|词根/把元音|带有|控制/精度|用笔，|就像:|默罕默德，|和书，|发言和给我更多单词/口语，|安静，|和穆斯林，|和 Fatimas，|同时，|同时，|然后这些|单词|他们每个人都|是名词，|由征兆|存在|noonation|in|结尾|天|Word|它。|标志|第三个|在|标志|名词:|入口|(基地)|in|第一|词，|就像:|男人，|小男孩朋克|和这匹马，|和这本书，|造的房子，|和学校，|然后这些|单词|他们每个人都|是名词，|由入口|alef 的|和醋|in|它的前面。|标志|第四:|入口|粒子的|从|颗粒|财产/所有格的情况下，|就像:|(你去了|从|这房子|到|学校)|然后每个|从|(房子)|并且|(学校)|是名词，|由入口|粒子的|拥有/所有格案件的|在他们身上|而存在|(基地)|in|他们的起点。|和颗粒|拥有/所有格案件的|他们是:|(从)|和由它|意义:|从它|开始|就像|(我走过|从|开罗)|并且|(转入)|和从|它的意思|结局，|就像|(我走过|到|亚历山德里亚)|并且|(从)|和从|它的意思|放弃，|就像|(我扔/火|箭头|从|弓)|并且|(上)|和从|它的意思|正在/升以上，|就像|(我爬上|打开|这座山)|并且|(中)|和从|它的意思|状语，|就像|(水|在|壶)|并且|(几个)|和从|它的意思|减少，|就像|(几|男士|大方|我见过)|并且|() baa|和从|它的意思|超过，|就像|(我通过|由谷)|并且|() kaaf|和从|它的意思|相似性，|就像|(非常漂亮|像满月)|并且|(醋)|和从|它的意思|拥有，|就像|(钱|属于穆罕默德)|() 1|和规范，|就像|(门|房子属于 /)，|(在垫子上|/ 属于清真寺)|和老有所为，|就像|(所有的称赞是由于|安拉)。|从|颗粒|财产/所有格案例:|颗粒|誓言，|和他们是|三|字母。|第一:|waw|它是|非|进入|除了|打开|名词|表观/可见，|就像|(由真主)|就像|(由山。|() 1|和一本书|刻)。(52: 1-2)|就像|(由国际体联|和橄榄。|() 1|和山|Sinai)(95:1-2)。|和第二个:|Baa，|而不是|有关由|语气词|无 / 其他比|语气词|事实上|进入|upon|名词|表观/可见，|就像|(由真主|我会努力工作)|和后|代词，|就像|(由你|我会打败|最懒惰的一个)。|和第三个:|taa，|而不是|进入|除了|upon|语气词|威严的|就像:|(和由真主|我肯定会打击计划|你的 idols)(21:57)。|问题|此培训完成后，受众能够做些什么?|迹象|名词吗?|此培训完成后，受众能够做些什么?|意思是|拥有/所有格案件的|语言词汇|和用语吗?|此培训完成后，受众能够做些什么?| Yin|noonation|语言|和用语吗?|后|什么|事||颗粒|表示:|从|laam|kaaf，|很少有人，|与，|在吗?|此培训完成后，受众能够做些什么?|其中|与有关的|waaw|誓言|通过输入|在上面|从|标志|名词吗?|此培训完成后，受众能够做些什么?|其中|与有关的|taa|誓言|通过输入|在上面吗?|举例说明|baa 的|誓言|两个例子|不同。|示例|请参阅|名词|有哪些|in|例子|之后:|带有|提及|标志|其中|你明白|与它|其名词:|量的名称|真主|最仁慈|最仁慈。|所有的赞美和感谢|是因为真主|耶和华|世界的...(1:1-2)|当然|祷告|被遗忘|从|污秽|与恶......(29)|时报 》|当然|人类|是在|的损失......(103-2)|和你的神|是神|一...(第 163 节)|最仁慈|所以问问|关于他|一个全意识到...() 25:59|当然|我的祈祷|和我的牺牲的仪式|和我的生活|我的死亡|真主确是|耶和华|世界，|否|合作伙伴|有他，|与此|我已吩咐，|和我|第一|穆斯林。(162-163)
GreatMasterpiece5=标志|动词的|它说:|和动词|据悉，|与肯定|见过，|并且|(会)|及 taa|女性气质|元音-少。|我说:|是尊敬|动词|从|它的兄弟|名词|与颗粒|四|迹象，|当|你找到了|在它|一|从他们，|或者|你看看|关于它|在它之前|你明白|它|是一个动词:|第一:|(肯定)|和第二次:|(看到)|和第三:|(会)|和第四次:|(taa|女性气质|元音-少)。|对于|(当然):|然后输入|upon|两个迹象|从|动词，|和他们是:|过去|和现在。|然后当|进入|upon|动词|过去式|它指示|upon|一|两层含义|-|两个是|确认|和近似。|-|然后示例|指示它|upon|确认|说|最高:|(当然|成功|是 believers)(23:1)|和说|陛下|那将会:|(最肯定|很高兴|真主|带有|believers)(48:18)|和我们说:|(事实上|出席|默罕默德)|和我们说:|(事实上|旅行|哈立德)|和实例|该值指示|upon|逼近|说|一位即将执行的开始|祷告:|(几乎怎么样|就要开始了|祷告)|对你说:|(几乎怎么样|是要设置|sun)(1)。|当|进入|upon|动词|存在|它指示|upon|一|两层含义|此外:|-|两个是|减少，|增加|-|然后为|其适应证|upon|减少，|然后就像|:|(很少/很少/偶尔|说出真相|说谎的人)|对你说:|(很少/很少/偶尔|是慷慨|吝啬的人)|对你说:|(很少/很少/偶尔|成功|最懒惰的一个 / 人)。|和|其适应证|upon|增加，|然后就像|你说:|(总是|获得|努力工作|他的目标)|和你说:|(总是|没有|虔诚的人|好)|和这句话|诗人:|总是|到达|慢的人|某些|他的目标|和总是|will|带有|急人|犯错的错误|和|所见|并将:|然后进入这两个|upon|动词|存在|只，|和他们是|提到|upon|未来，|及其意义|以后|除了|那|(看到)|我说|未来|从|(将)。|然后为|所见|然后就像|它说|大多数 High\:|(很快就会说|愚蠢的|从|people)(2:142)，|(很快就会说|给你|successors)(48:11)|和|(会)|然后就像|他说|最高:|(然后将|给你|你的主|content)(93:5)，就可以|(将|我们给他们展示|fire)(4:56)|([阿拉] 意志|给他们|他们的工资 [在判断 day])(4:152)。|和|taa|女性气质|元音少:|然后输入|upon|动词|过去式|无|其他比它;|和目的|它的|是的征兆|upon|那|名词|其中|分配|那|谓词|为它|是的女性气质;|是否|它是|活跃，|就像:|(说|阿伊莎|母亲|信徒)|或者|was|副|活动，|就像|(地毯|我们的房子|以传播/扩展名)。|目的是|它|是元音少|in|原始|其完备性|然后不|受损的伤害|其 vowelization|为意外|除掉了|从|会议|两个 sukoon|in|就像|这句话|最高:|(和她说|出去|从 them)(12:31)，|(和她说|命令|到 Pharaoh)(28:9)，|(他们说|我们来|obedient)(41:11)。|从那|前面提到的|变得清晰|给你|那|标志|动词的|其中|提到他们|作者|upon|三|部件:|第部分|具体来说|进入|upon|过去，|它是|taa|女性气质|元音少|和部分|具体来说|进入|upon|目前，|它是|所见|并将|和部分|共享|他们两个之间|它是|当然可以。|和肯定|省略|标志|动词的|命令，|它是|说明|upon|请求|带有|它接受|yaa 的|第二人|或者|中午|重点|就像|(设置)|并且|(坐)|并且|(写)|并且|(看起来)|然后当然|这些|单词|四|种种迹象表明|upon|请求|寻找|站立|和坐|和写作|看，|带有|验收|yaa 的|第二人|in|就像|(你的立场，|和你坐)|或者|带有|验收|中午|重点|in|示例|(让我们写，|让我们看看|到|什么|好处)。|问题|此培训完成后，受众能够做些什么?|的|标志|动词?|自|几个|部件|划分|标志|动词?|此培训完成后，受众能够做些什么?|的|标志|其中|标识|与动词|过去吗?|多少|标志|正在确定|与动词|本?|此培训完成后，受众能够做些什么?|的|标志|有哪些|共享|介于|过去式|和现在吗?|此培训完成后，受众能够做些什么?|的|含义|其中|指示|在上面|(当然) 吗?|后|什么|事情|指示|taa|女性气质|元音-少吗?|此培训完成后，受众能够做些什么?| Yin|意义|其中|指示|在上面|所见|和会吗?|和什么|区别是|他们两个之间?|如何|你明白吗|标志|区分|动词|命令吗?|给|两个例子|在|(肯定)|该值指示|upon|肯定，|让|两个例子|were|在他们|(几乎怎么样)|该值指示|upon|逼近，|让|两个例子|were|(当然几乎/怎么样)|in|其中两个之一|该值指示|upon|逼近|中和|其他|该值指示|upon|确认，|让|两个例子|were|(很少/很少/常)|in|其中两个之一|该值指示|upon|递减 |和了|in|结尾|该值指示|upon|增加，|让|示例|一|允许|在它|(很少/很少/常)|那|were|适应证|upon|递减 |和增加，|让|对于|(当然几乎/怎么样)|与示例|一|允许|在它|那|were|适应证|upon|逼近|或者|确认，|和标准|in|那|示例|其中|was|该值指示|upon|确认|而|was|该值指示|upon|逼近。|演习|区分|名词|和动词|其中|在|短语|给出，|辨析|每隔|类型|在|类型|动词，|带有|一提|标志|其中|显示|与它|upon|名词化结构|这个词的|或者|其实际的/有效，|和他们是:|(如果|你表明|好|或者|隐藏它|或者|再说一遍|从|进攻|然后当然|真主| Yin|曾经赦免|和 Competent)(4:149)|(|事实上|萨法|和马尔瓦|来自|标志|真主||所以无论谁|使主要的朝圣之旅|到房子|或者|执行次要朝圣|然后不|责备|在他身上|那|他 circumambulates/走之间|他们两个||和谁|志愿者|好|然后当然|真主|感谢|和 Knowing)(2:158)。|说|祈祷|真主|在他身上|与和平:|将会有|风暴|一坐|在它|更好|从|一个站|和一个站|在它|更好|从|是走|和一个走|在它|更好|从|一个运行|谁|有恩典|从它|必须保护自己|和谁|发现|在它|住房|或者|避难|然后避难|有了它。
GreatMasterpiece6=粒子|它说:|粒子|it|非|不接受|与它|适应证|名词的|而不是|适应证|名词。|我说:|尊敬的|粒子|从|它的兄弟|名词|和动词|与那它|非|不接受|进入|标志|从|标志|名词的|上一页|而不是|其他比它|在其上，|正如|非|不接受|进入|标志|从|标志|动词的|其中|我们以前有|解释|而不是|其他比它|在上面。|和它的示例|(从)|并且|(am/是/是/有/有/已/将)|并且|(没有)|这些|单词|三|是的粒子|因为他们|非|允许做|Al-|而不是|noonation，|而不是|允许|进入|粒子|所有格/所有格案件的|在其上，|然后不|接受|那|是说:|从，|而不是|那|是说:|从，|而不是|那|是说:|到|从|和像那样|与其他|颗粒，|和也|非|接受|那|进入|在上面|所见，|而不是|(会)|而不是|taa|女性气质|元音-少，|而不是|() certainly\almost\rarely\often|而不是|其他比它|从什么|它是|标志|upon|那|这个词|是一个动词。|演习|1-|付诸表决|每隔|Word|从|单词|给出了|in|语音|有意义|好|沉默/停止|上它。|棕榈树。|大象。|他睡着了。|他的理解。|花园里。|土地/地球。|水。|他吃。|果实。|果实。|他的收成。|他学习。|2-|付诸表决|in|这个地方|空闲|从|每隔|示例|从|例子|关注|Word|完成|与它|意思，|请参阅/解释|之后|那|数量|部分|天|示例中，|和意义|天|部分。|(裁决)|他能记住|......|一课。|(B)|......|土地/地球。|(C)|他游泳|......|in|早晨。|(代理)|它航行|......|in|海洋。|(E)|去了|......|in|空气。|(F)|他增加|......|与国家|埃及。|(G)|父亲|......|upon|他的儿子。|(H)|那个男孩|有礼貌|......|() i|......|鱼儿|in|水。|(J)|阿里|花/花。|3-|请参阅|动词|过去，|和动词|目前，|和动词|命令，|与不可数名词，|和颗粒，|从|标志|之后:|非|已分配|真主|报信人|从|两颗心|in|他 body(33:4)|......|是渴望|聪明的人|upon|快乐|他的主|......|培养|你的世界|像你一样|将活|永远|......|努力|那个年轻人|对的事情|从不|他会实现它，|从不|你将会实现|荣耀|直到|你品味舔|耐心/芦荟|......|If|你们是诚实|你终将获胜|......|当然|是成功|谁净化自己，或使它成长|和肯定|是一个失败|谁埋葬自己或它的特技。
GreatMasterpiece7=它说:|(门|变化)|拐点|它是:|它改变了|结局|词的|由区别|是活动元素摄政王|进入|在上面|表观|或者|假设。|我说:|拐点|它是|两层含义:|两个第一|词汇语言|和其他|术语。|对于|意义|in|语言|然后是:|披露|和博览会，|你说:|我表达清楚|这是|in|我自己内心的我，|当|它被披露|和证明所示。|和|它的意思|in|术语|然后它是|什么|被提及|作者|他的演讲|正在更改|它的结局|这个词的|-|等/到结尾。|和预期|从|(更改|结尾|这个词)|CHANGES|的状态|结束|这个词，|而不是|它意味着|那|它想要|CHANGES|实际/自我|结局，|然后当然|结局|这个词的|本身|非|改变，|更改|国家|结束|这个词的|短语|那|其变化|从|主格|到|宾格|或者|所有格:|实际/文字|或者|假设/裁决|和会|那|更改|原因理由|正在更改|摄政王/积极的元素的|从|摄政王/主动元素|需要|主格|upon|有效性|或者|喜欢它，|到|结尾|需要|宾格|upon|动词|或者|喜欢它，|等|上。|举个例子|当|你说:|(出席|默罕默德)|然后默罕默德:|主格，|然后真正是|被动语态|元素|需要|主格|upon|有效性，|和那|作用|它是|(他出席)|然后当然|你说:|明白了|默罕默德|正在更改|条件|最后一个|(穆罕默德)|到|宾格;|为改变|行动|与行动|最后一个|需要|宾格|它是|(见)，|然后当|你说:|(我赢了|与默罕默德)|CHANGES|条件|在它以后|到|所有格|为改变|行动|与行动|最后一个|需要|所有格|它是|baa。|和什么时候|你的思考|in|那|示例|显示|给你|那|结尾|这个词的|-|它是|扁豆|从|默罕默德|-|非|对它，任何更改|和那|其中|CHANGES|它是|美国|它的结局:|那么肯定你|将会看到|主格|in|该示例|第一，|和宾格|in|该示例|第二，|和所有格|in|该示例|第三个。|和那|更改|从|条件|主格|到|条件|宾格|到|条件|所有格|它是|拐点|带有|作者|和从|它去|他的思想学派，|和那|元音|三|-|其中|它是|主格|和宾格|和所有格|-|它是|标志|和州|upon|拐点。|和喜欢|名词|in|那|动词|目前，|然后不|你说:|(游记|亚伯拉罕)|然后旅行:|一个动词|存在|主格;|它是免费的|从|活动元素|需要它|宾格|或者|活动元素|需要它|命令/斜的情况下，|然后当|你说:|(不会的|传播|亚伯拉罕)|CHANGES|条件|(他旅行)|从|主格|到|宾格|正在更改|活动元素|与活跃的元素|其他|要求|宾格|它是|(不会)|然后当|你说:|(没有|传播|亚伯拉罕)|它改变了|条件|(他旅行)|从|主格|或者|宾格|到|命令/斜的情况下，|CHANGES|活动元素|与活跃的元素|其他|要求|命令/斜的情况下，|它是|(没有)。|和知道|那|此|更改|划分|到|两个部分:|口述/语音，|并暗示本应。|然后为|口述/语音|和它是:|什么|非|防止|从|送电|它的|防止|就像|你看见|in|词根|扁豆|从|(穆罕默德)|和词根|raa 的|从|(他旅行)。|和|暗示本应:|它是|什么|防止|从|发音|与它|防止|从|不可能，|或者|困难，|或者|适宜性;|你说:|(调用|那个男孩|法院和法官|和我的仆人)|然后调用:|主格|免费|从|宾格|与命令/斜案例、|和男孩:|主格|为正在|活跃，|法院和法官|和我的仆人:|这两个主格|因为他们两个|耦合|upon|活动元素|主格|因为|dammah|非|出现|in|结尾|这|词，|它的不可能性|in|(男孩)|这是个难题|in|(调用)|中和|(法官)|和原因|适用性|yaa 的|第一人|in|(我的仆人);|然后你有|dammah|隐藏|upon|结尾|这个词的|防止|从|其表观/明显|不是可能，|或者|困难，|或者|放置|这个地方|与元音|合适。|你说:|不会|很高兴|那个男孩|法院和法官|和我的仆人)|和你说:|(当然|那个男孩|和我的仆人|都是赢家)|和你说:|(我通过|那个男孩|和我的仆人|法院和法官)。|然后不|was|最后一次|阿勒夫|正确/必要|暗示本应|在上面|全部|元音|为不可能的事|并要求|名称|已终止|由阿勒夫|有限公司|示例|那个男孩|与棍子|和情报|和手磨机|和知足。|而不是|was|它的结局|yaa|正确/必要|暗示本应|在上面|dammah|和 kasra|为困难/沉重|和电话|名称|终止|以 yaa|不完美|和明显明显|在上面|fathah|对于明度，|就像:|法官，|邀请人，|和攻击者，|与转轮，|后起之秀，|和投掷者。|非|was|着魔|到|yaa|第一人|暗示本应|在上面|元音|他们每个人都|适当性，|就像:|我的仆人，|和我的书，|和我的朋友，|和我的父亲，|和我的老师。
GreatMasterpiece8=反对|拐点/大写结尾|不是变性/结构，|和会变得清晰|每隔|一|从他们|完成|清晰度|原因|解释|最后，|和肯定|已省略|作者|解释|结构/不变性|和我们|解释|给你|upon|方式|其中|解释|与它|拐点/案件的结局，|然后我们说:|结构/变性/不变/建设|有两层含义:|第一|是词法作用域|和第二个|术语:|然后为|它的意思|in|语言|然后它是|短语|那|是把|东西|upon|其他的东西|upon|侧边|探索|与它|稳定/稳固性|和必要性。|和|它的意思|in|术语|然后它是|含义|结局|这个词的|条件|一|其他|摄政王|和没有|缺陷，|和那|像的含义|(多少)|并且|(从)|元音-少，|和像意蕴|(这些)|并且|(一个女人的名词)|并且|(昨天)|kasra，|和像意蕴|(前)|并且|(无论)|damma，|和像意蕴|(在那里)|并且|(如何)|罚的骂。|从|这些|澄清|你知道的|那|标题|结构/不变性|四:|元音-少，|和 kasra，|和 damma，|和罚的骂。|前后|解释|每个|这些|事情|非|困难|在你身上|知识|拐点|结构/不变，|然后如果|拐点:|非|其他|条件|结束|表达式|或者|正在更改|由原因|因素，|和结构/不变:|非|有必要|它的结局|条件|一|其他|活动元素|和弱点。|演习|请参阅/解释|拐点|与它的语法，|结构/不变，|从|单词|发生|in|短语|给出:|说|阿拉伯人:|真主|补偿|什么|已销毁|人/人类，|和时间|毁坏|什么|他们收集了，|和许多/频繁|从|死亡|在他们身上|搜索|生活，|和生活|其原因|曝光/面对|死亡。|问|欧麦尔|儿子|哈塔卜的|阿姆拉|儿子|Madeeakarib|从|这场战争，|然后说:|对他说:|它是|苦涩|它的味道，|当|变得更少|从|暴力，|谁|是病人|在它|将已知，|和谁|是弱|从它|将被销毁。|(由早上的阳光|() 1|和夜晚|当|它涵盖了|() 2|非|已经忘了你|你的主|而不是|离弃了你|() 3|和来世|是更好|给你的|于|第一次)|当然|超越|告诉我|揭示了|真相|在什么|你报告|那|荣誉|in|运输|当|睡着了|没有经验|in|中东|夜的|然后看|然后|为阁下|我还流鼻涕|和小茴香|当|您|不会|缩短|从|无知|与背叛|我曾经是|忍耐|或者|你降临|无知|有耐心的人|upon|权限|骑士精神的|大多数|从|病人|upon|疼痛|需要，|与羞愧|贫穷的|禁止|从|荣耀|耐心的|正如|那|荣耀|财富|防止|从|慷慨大方|公平。|问题|此培训完成后，受众能够做些什么?| Yin|拐点/案件的结局吗?|此培训完成后，受众能够做些什么?| Yin|结构/不变性?|此培训完成后，受众能够做些什么?| Yin|屈?|此培训完成后，受众能够做些什么?| Yin|结构/不变吗?|此培训完成后，受众能够做些什么?|意思是|(更改|其他|字)?|自|几个|部件|划分|更改吗?|此培训完成后，受众能够做些什么?| Yin|变化|表达吗?|此培训完成后，受众能够做些什么?| Yin|变化|应该吗?|此培训完成后，受众能够做些什么?|是的原因|变化|应该吗?|提及|两个原因|用什么|防止|发音|与元音。|给我|三|示例|演讲|有用，|因此|它是|in|每个|示例|一个名词|拐点|与词根|暗示本应|防止|从|其明显|不可能的事。|给我|两个例子|演讲|有用|in|每个|一|从他们|名词|拐点|与词根|暗示本应|防止|从|其明显|困难。|给我|三|示例|演讲|有用|in|每隔|示例|与它|一个名词|结构/不变。|给我|三|示例|演讲|有用|它是|in|每隔|示例|与它|一个名词|屈|与词根|暗示本应|防止|从|其明显|恰当。
GreatMasterpiece9=部分|拐点|它说:|和它的零件|有四个:|主格，|和宾格|和所有格，|与命令/斜案例、|然后为名词|从|那|主格，|和宾格|和所有格，|而不是|命令/斜案例|在它，|然后为动词|从|那|主格，|和宾格|与命令/斜案例、|而不是|所有格|在它。|我说:|种类|拐点|其中|发生|in|名词|和动词|一共|四:|第一:|主格，|第二种:|宾格的情况下，|第三:|所有格，|第四:|命令/斜，|并为每个|一|从|这些|部件|四|意义|in|词汇，|和意义|in|术语|下降了。|对于|主格|然后它是|in|词汇:|殿下|和高程，|它是|in|术语:|更改/变化|独占|它是已知的|damma|和什么|可能在的地方|它，|和公认|附近的|什么|位置|从|damma|in|分离|完全|If|遗嘱|真主，|和位于|主格|in|每个|从|名词|和动词，|就像:|(站立|阿里)|并且|(唱|白头翁/夜莺)。|和|宾格|然后它是|in|词汇:|解决|和直线度，|它是|in|术语|正在更改|特殊|它的标志|是罚的骂|和什么|可能在的地方|在其上，|和存在|宾格|in|每个|从|名词|和动词|此外，|就像:|(也不会|我爱|懒惰)。|和|所有格|它是|in|词汇:|降低/自卑，|它是|in|术语:|正在更改|特殊|标志|kasra|和什么|可放|在其上，|而不是| Yin|所有格|除了|in|名词，|就像:|(我遭受感到疼痛|从|懒惰的人)。|和|命令的情况下|它是|in|词汇:|切断，|中和|术语|正在更改|特殊|标志|sukoon|和什么|可放|在其上，|而不是| Yin|命令的情况下|除了|in|动词|现在时态|就像:|(并不|赢得|懒惰的人)。|然后当然|已显示|给你的|那|类型|拐点/案件的结局|upon|三|部件:|部件|共享的类型|介于|名词|和动词，|和他们是|主格|和宾格，|和部分|相关|以名词，|它是|所有格，|和部分|相关|用的动词，|它是|命令的情况。|问题|是什么|类型|拐点?|此培训完成后，受众能够做些什么?| Yin|主格|词法上|和术语吗?|此培训完成后，受众能够做些什么?| Yin|宾格|词法上|和术语吗?|此培训完成后，受众能够做些什么?| Yin|所有格|词法上|和术语吗?|此培训完成后，受众能够做些什么?| Yin|命令的情况下|词法上|和术语吗?|此培训完成后，受众能够做些什么?|类型|拐点/大写结尾的|有哪些|共享|在它|名词|与动词?|此培训完成后，受众能够做些什么?|其中|有关|与它|名词|从|标志|屈折变化/案件的结局吗?|此培训完成后，受众能够做些什么?|其中|有关|与它|动词|从|标志|屈折变化/案件的结局吗?|给|四|示例|为每个|从|名词|主格，|和动词|宾格|和名词|所有格，|和动词|命令的情况。
GreatMasterpiece10=它说:|(章|第一个|标志|拐点/案件的结局)|为主格|in|四|体征:|damma，|和 waw|和阿勒夫|到中午。|我说:|你就能|到|了解|那|这个词|是主格|与存在|迹象|in|它的结局|从|四|体征:|一|从它|原件/源，|它是|damma，|和三个|分支|从它，|和他们是:|waw|和阿勒夫|到中午。
GreatMasterpiece11=地方/职位|damma|它说:|然后为|damma|然后它是|标志|为主格|in|四|职位:|名词|单个窗体，|和复数|坏了，|和复数|女性|声音，|和动词|存在|其中|什么也没有|附加与联系|与它的结局|所有的东西。|我说:| Yin|damma|标志|upon|主格|这个词的|in|四|职位:|位置|第一:|名词|奇异，|和位置|第二:|复数形式|坏了，|和位置|第三:|复数|女性|声音，|和位置|第四:|动词|存在|其中|什么都不|已连接|与它|阿勒夫|二元性|而不是|waw|所述多个，|而不是|是啊|解决，|而不是|中午|左证|将它光|或者|重，|而不是|中午|女性的特质。
GreatMasterpiece12=和|名词|单数|然后是打算这么|与它|在这里:|什么|还没有|二元性|而不是|多元化|而不是|加入|给他们|而不是|从|名词|五:|是否|我有|意味着意欲 /|与它|男性|例如:|默罕默德，|阿里|和哈姆扎，|或者|was|意味着意欲 /|与它|女性气质|例如:|法蒂玛，|和阿伊莎，|和赞，|和天气|她是|damma|可见明显|像什么|在|例如:|(出席了|默罕默德)|并且|(游记|法蒂玛)，|或者|她是|应该|就像:|(出席|那个男孩|法院和法官|和我的兄弟)|就像:|(结婚|晚上|和拿俄米)|然后如果|(穆罕默德)|以及|(法蒂玛)|是两个主格|和标志|他们主格的|damma|很明显，|并且|(男孩)|和它的例子|(夜)|并且|(俄)|是主格，|和标志|主格的|是 damma|应该|upon|阿勒夫|防止|从|其可见/明显|不是可能，|并且|(法官)|是主格，|和标志|它主格的|是 damma|应该|upon|是啊|防止|从|其可见/明显|困难，|并且|(哥哥)|是主格，|和标志|它主格的|damma|应该|upon|什么|早于|是啊|第一人|防止|从|其可见/明显|词根|适当。
GreatMasterpiece13=替换|waw 的|从|damma|它说:|和|waw|然后是|标志|为主格|in|两种情况:|in|复数|男性|声音，|中和|名词|五、|和他们是:|你的父亲，|和你的兄弟，|和你的公公，|和你的嘴，|和拥有化学武器的国家|财富。|我说:|was|waw|标志|upon|主格|单词|in|两种情况:|第一:|复数|男性|声音，|与案例|第二:|名词|五。|对于|复数|男性|声音，|它是:|一个名词|该值指示谈到|upon|结束|从|两个，|随着增加|in|它的结局，|它是有效|免费|从|此|另外，|和加入|到喜欢|它，|就像:|(很高兴|那些被留下 behind)(9:81)，|(但|那些人是坚定|in|知识|从他们|和 believers)(4:162)，|(而且如果|恨/不喜欢它|criminals/guilty)(8:8)，|(如果|有|从你|二十|steadfast)(8:65)，|(和其他人|已确认|他们的 faults)(9:102)。|然后每个|发件人:|(那些被留下的人)|并且|(那些人是坚定)|并且|(信徒)|并且|(罪犯/有罪)|并且|(坚定/病人)|并且|(其它)|复数|男性|声音，|指的|upon|多|从|两个，|并且在它|另外|in|它的结局|-|它是|waw|到中午|-|它是|有效|免费|从|此|增加，|非|参见|给你的|你说:|遗弃的人，|和一个人是坚定的|和一个信徒，|和刑事/有罪之一，|和病人/坚定之一，|和另一个，|和每个|表达式|从|表达式|复数|事件|in|此|签名|主格，|和标志|它主格的|waw|更换|从|damma，|与此|中午|其中|在以下日期之后|waw|替代品|从|tanween|in|你说:|(负责人)|和其他比它，|它是|名词|奇异。
GreatMasterpiece14=替换|阿勒夫|从|damma|它说:|和|阿勒夫|然后是|标志|为主格|in|双|名词|特别。|我说:|was|阿勒夫|签名|upon|主格|这个词的|in|箱子|一个人，|它是|名词|双，|就像|(出席|这两个朋友)|然后这两个朋友:|双，|它是|主格|因其|是摄政王，|和标志|它主格的|更换|阿勒夫|从|damma，|到中午|替代|对于|noonation|in|你说:|一位朋友，|它是|一个名词|奇异。|和双|它是:|每隔|名词|该值指示|upon|两个男性|或者|两个女性，|随着增加|in|它的结局，|就足够了|此|增加|带有|合取|和附加，|就像:|走近|两个火星叔叔，|和两名印度人)|然后两个火星叔叔:|表达式|该值指示|upon|二|名词|每个|一|从它|欧麦尔|有理由|存在|添加|in|它的结局，|与此|添加|它是|阿勒夫|到中午，|和它|就足够了|从|参与|带有 waw|合取|和细化|名词|因此|你说:|(出席|欧麦尔|和欧麦尔)|和像那样|两个印第安人;|它是|表达式|该值指示|upon|两个女性|每隔|一|从这两个|其名词|印度人，|和原因|它指示|upon|那|添加|alef 的|到中午|in|该示例中，|以及存在|alef 的|到中午|够你|那|参与|带有 waw|合取|和细化|名词的|因此|你说:|(出席|印度|和印度)。|演习/练习|1-|答复|每隔|复数|从|复数|关注|到|奇异的男性，|并且|然后|奇异的女性，|然后|放|每个|双|in|单词|有用有益|因此|was|主格，|和在这里|占有人|复数形式:|骆驼，|大象，|剑，|坦克，|油墨罐|星星，|花园，|花园，|论文，|面包店，|鞋，|衬衫，|医生，|路线的方法，|可敬，|椅子/座位，|科学家，|墙壁，|windows，|门，|windows，|少女们怀念，|弓，|事项/事务，|国家，|国家，|苹果。|2-|地方|每个|一|从|对偶形式|给出了|in|语音|很有用:|这两位科学家，|两位领导人，|这两兄弟中，|两个硬工人，|两个指南，|这两个朋友，|在两座花园，|两个女孩，|两本书中，|两个的尊敬，|这两个国家，|两堵墙，|两位医生，|两个事项/事务，|两个骑马的|两个椅子/席位，|两个处女，|两把剑，|这两个杰出的|这两封信，|两位家长，|这两个国家，|在两座花园，|每个进入两个的方式，|两个蝴蝶结，|两个国家，|两扇门，|两个苹果，|两颗星。|3-|付诸表决|in|这个地方|空白/空|从|标志|给出了|表达式|双:|(裁决)|旅行|......|到|埃及|看|它的纪念碑。|(B)|已参加|我的兄弟|和他一起|......|所以我对他们感到很荣幸。|(C)|有|哈立德|......|和他命名|两个之一|默罕默德|和他命名|其他|阿里。|问题|输入|几个|案件|was|阿勒夫|标志|upon|主格|这个词吗?|此培训完成后，受众能够做些什么?| Yin|双吗?|生成|双窗体|两个例子:|第一|男性，|和其他|女性。
GreatMasterpiece15=替换|中午|从|damma|它说:|和|中午|然后是|签名|为主格|in|动词|目前，|当|连接的|与它|代词|二元性|或者|代词|所述多个，|或者|代词|女性气质|每秒处理的人。|我说:|was|中午|标志|upon|那|Word|其中|它是|in|它的结局|主格|in|箱子|一个人，|它是|动词|现在时态|已连接|到|阿勒夫|第二个男性|或者|第二次的女性，|或者|连接的|到|waw|复数形式|男性，|或者|连接的|到|是啊|女性气质|每秒处理的人。|和|所附|到|阿勒夫|第二个男性|然后就像|(这两个朋友|将旅行|明天)，|就像|(你们两个|将旅行|明天)，|然后我们说:|(这两个出差旅行)|和喜欢|(你们两个出差旅行)|一个动词|现在时态|主格，|免费从粒子|从|宾格|与命令的情况下，|和标志|主格的|是的存在|中午，|和阿勒夫|第二个|活跃的元素，|结构|upon|sukoon|in|地方|主格。|然后当然|你看看|那|动词|现在时态|连接的|到|阿勒夫|第二个|5 月|一直|已启动|与阎|用于指示|upon|三人|像什么|in|该示例|第一，|和 5 月|一直|正在启动|与 tah|用于指示|upon|第二人|喜欢|in|该示例|第二次。|和|所附|到|阿勒夫|女性双|然后就像:|(两个印第安人|将旅行|明天)，|和一样:|(你们两个|O 两个印第安人|将旅行|明天)，|然后她是 / 你出差旅行|in|两个例子:|一个动词|现在时态|主格|与证据|中午，|和阿勒夫|是活跃的元素，|结构|upon|sukoon|in|地方|主格。|并且从他们|你知道的|那|动词|现在时态|连接的|到|阿勒夫|这第二位女性|非|was|正在启动|除了|与 tah|用于指示|upon|女性气质|活动元素的|是否|was|三人|如示例所示|第一，|或者|was|存在|每秒处理人|如示例所示|第二次。|和|所附|到|waw|所述多个，|就像|(男人|真诚|他们|谁|完成/必须做|他们的职责)，|就像|(你所有|O 我的人|完成/必须做|你的职责)|然后他们履行/必须做|-|和喜欢它|你满足吗/你必须做|-|一个动词|现在时态|主格，|和标志|它主格的|是证据|中午，|和 waw|所述多个|活跃的元素，|结构|upon|sukoon|in|地方|主格。|并从它|你知道的|那|动词|现在时态|连接的|到|此|waw|当然|was|正在启动|与阎|用于指示|upon|第三次的人，|像什么|在|该示例|第一，|和肯定|was|正在启动|与 tah|该值指示|upon|每秒处理的人，|像什么|在|该示例|第二次。|和|所附|到|是啊|女性气质|每秒处理人|然后就像|(你|O 后腿|知道|你的职责)|然后你知道:|一个动词|现在时态|主格，|和标志|它主格的|是的证据|中午，|和严|女性气质|每秒处理人|是活跃的元素，|结构|upon|sukoon|in|地方|主格。|而不是|was|动词|连接的|到|此|是啊|非|正在启动|与 tah，|它是|该值指示|upon|女性气质|积极元素。|所以总结|给你的|那|连接的|到|阿勒夫|was|正在启动|与 tah|或者|有呀，|金及附加|到|waw|诸如此类|was|正在启动|与 tah|或者|有呀，|金及附加|到|是啊|非|was|正在启动|除了|与 tah。|和它的例子:|两人男性站，|和你两两的女性立场，|他们男性立场、|和你所有男性的立场，|和你女性的立场，|和命名|这些|示例|(动词|五)。|练习/演习|1-|付诸表决|in|每隔|地方|从|地方|自由/空|一个动词|从|动词|五|发生，|然后|参考|到|什么|事情|表示|信件|现在时态|其中|它开始|与它:|(裁决)|男孩子们|......|in|这条河。|(B)|父亲|......|对|他们的儿子。|(C)|你们两个|O|年轻的男孩|......|速度慢。|(代理)|这些|男士|......|in|字段。|(E)|您|阿赞|......|你的职责。|(F)|两位年轻的女士|......|那个士兵。|(G)|您|O|男士|......|你的国家。|(H)|您|阿萨阿德||用球。|2-|用|每隔|谓词|从|动词|给出了|in|一个句子|有意义/有用:|两个女性 / 你们两个玩，|女性的你，|所有男性都培养你，|两个女性 / 你们两个收获，|两个女性 / 你们两个谈，|你所有男性走，|他们男性游泳，|所有男性的为您服务，|两个女性 / 你们两个生产，|你所有女性同意接受。|3-|付诸表决|带有|每隔|Word|从|单词|给出了|一个动词|从|动词|五|发生，|和使|带有|复数形式|语音|有意义/有用:|这两个学生，|两个小男孩，|而那些穆斯林，|男子|谁|保持|他们的职责，|您|O|年轻的女孩，|您|O 人，|这些|同学们，|If|你反对|订单|真主。|4-|请参阅|主格|与 damma，|和主格|alef|和主格|带有 waw|和主格|证据|中午，|带有|引用|每隔|一|从他们，|从|引用|这个词|收入|in|标志|给出:|书籍|万王之王|他们的缺点|有保障|与他们，|和耳洞的权限|通知，|和自己的舌头|目睹了，|勇气|是一种自然的冲动|已放置|真主|为谁|他所意欲者|从|他的仆人，|感恩|给两个感谢:|与清除|忙，|与报告|用舌头，|和两个第一|传达|从|两个，第二个|敬畏神|他们|那些是谁|相信|在安拉|和一天|最后。|问题|输入|几个|案件|was|中午|标志|upon|主格|这个词吗?|用什么|启动|动词|现在时态|连接的|到|阿勒夫|第二个呢?|后|什么|事|指示|字母|正在启动|与它吗?|用什么|开始时间|动词|现在时态|连接的|对 waw|或者|是啊?|给|两个例子|为每个|从|动词|现在时态|连接的|到|阿勒夫|及至|waw|及至|是啊。|此培训完成后，受众能够做些什么?| Yin|动词|五个吗?
GreatMasterpiece16=标志|宾格的|它说:|和宾格|五|标志|罚的骂，|和阿勒夫|和 kasra，|和呀，|和删除|中午。|我说:|你能给|那|裁决|到|这个词|与那它|发生|当|已找到|in|它的结局|标志|从|五|体征:|一|从它|源语言|它是|罚的骂:|和四个|分支|从它，|和它是:|阿勒夫|和 kasra，|和呀，|和删除|中午。
GreatMasterpiece17=罚的骂|和其案件|它说:|然后为|罚的骂|然后是|标志|为宾格|in|三|例:|in|名词|奇异，|和复数|坏了，|和动词|现在时态|当|输入|到它|虚拟语气的情况下，|并没有|连接的|与它的结局|所有的东西。|我说:|was|罚的骂|标志|到|那|这个词|是宾格|in|三|情况下，|案例|第一:|名词|奇异，|与案例|第二:|复数|坏了，|与案例|第三:|动词|现在时态|其中|它前面|虚拟语气的情况下，|不具有|连接的|与它的结局|阿勒夫|第二，|而不是|waw|所述多个，|而不是|是啊|处理/第二人，|而不是|中午|重点，|而不是|中午|女性的特质。|对于|名词|单数|然后当然|字样/以前|其已知/定义，|和罚的骂|was|表观|upon|它的结局|in|就像|(我见过|阿里)|就像|(我见过|后腿)|当年的阿里，|和后腿:|两个名词|奇异，|和两个|宾格;|当然那两个|都是活跃的元素，|和标志|两个宾格|罚的骂|很明显，|和第一次|男性|和第二个|女性，|和是|罚的骂|应该/暗示|就像:|(我见过|那个男孩)|和一样:|(我报道|那个女孩)|然后那个男孩|和女孩:|两个名词|单数|是宾格;|因为|每个|从这两个|事件|是有源元件|有了它，|和标志|两个宾格|是罚的骂|应该/暗示|upon|阿勒夫|防止|其明显|不是可能，|和第一次|男性|和第二个|女性。|和|复数|破碎|然后当然|以前|其定义已知 /|此外，|和罚的骂|当然|was|表观|upon|它的结局，|就像|(我陪同|男人)|就像|(我照顾|印度人)|然后男人|和印地安人:|复数|破碎|宾格|因为这两个|都是活跃的元素，|和标志|其宾格的|是罚的骂|很明显，|和第一次|男性，|和第二个|女性，|和肯定|was|罚的骂|应该所隐含，|就像|它说:|最高:|(和你将看到|人类|在醉酒的 state)(22:2)|就像|它说:|最高:|(和嫁给|那些你们当中那些 single)(24:32)|然后在醉酒状态|和那些你们中间是单身:|复数|破碎|宾格;|因为这两个|都是活跃的元素，|和标志|其宾格的|是罚的骂|应该/暗示|upon|阿勒夫|防止|从|其明显|不可能的事。|和|动词|现在时态|男性|然后就像|它说:|最高|(不会的|我们停止|在上面|worshiping)(20:91)|然后|(我们停止):|一个动词|现在时态|虚拟案例|将不，|和标志|其虚拟语气案件|罚的骂|很明显，|和肯定|was|罚的骂|应该所隐含，|就像|(这让我高兴|那|你努力|对|荣誉)|然后|(你努力):|一个动词|现在时态|虚拟案例|这一点，|和标志|其虚拟语气案件|罚的骂|应该/暗示|upon|阿勒夫|防止|从|其明显|不可能的事。|然后如果|连接的|与结局|谓词|现在时态|阿勒夫|第二，|就像|(永远不会|这两个会命中/击败)|或者|waw|所述多个，|就像|(永远不会|你们都将命中/击败)|或者|是啊|处理/第二人，|就像|(永远不会|你女性将命中/击败)|非|was|其虚拟案例|与罚的骂，|然后每个|从|(两会命中/击败)|并且|(你所有将命中/击败)|并且|(你女性将命中/击败)|都宾格|与永远不会，|和标志|其虚拟语气案件|删除|中午，|和阿勒夫|或者|waw|或者|是啊|活动元素|结构|upon|sukoon|in|地方|指示的情况下，|你就会明白|解释|，|在什么|如下。|如果|连接的|与它的结局|中午|重点|重，|就像|(由真主|从不|可以肯定你会)|或者|光|(由真主|从不|可以肯定你会)|它是|结构|upon|罚的骂|in|地方|虚拟案例。|如果|连接的|与它的结局|中午|女性的特质，|就像|(永远不会|你所有女性将达到|荣誉|除了|与义)|它是|然后|结构|upon|sukoon|in|地方|虚拟案例。|练习|1-|用|单词|关注|in|句子|有意义|因此|was|宾格:|字段，|花，|同学们，|球，|花园里，|这条河，|这本书，|在两座花园，|这支笔，|这匹马，|这两个男孩，|处女，|棍子，|为指导，|他喝，|他接受，|他希望，|你去旅行。|2-|付诸表决|in|地方|从|这个地方|自由/空|in|短语|给出了|名词|发生|宾格|与罚的骂|很明显，|并将其设置|窗体:|(裁决)|真正|......|同情|对|他们的儿子。|(B)|服从|......|因为他|你长大|和你的教育。|(C)|尊重|......|因为她|给你带来。|(代理)|修订​​|......|之前|那|呈现它。|(E)|执行|......|然后你真|通过这|服务|你的国家。|(F)|被|......|为确|怯懦|非|延长|生活。|(G)|总是有|......|为确|闲谈|是之前故障的缺点。|(H)|保护|......|当从|发言|到|人。|() i|If|男子|......|他是|那些人|保持|他的职责。|(J)|谁|服从|......|进来|危险/危险的情况。|(K)|执行|......|即使|对于|其他比|他的人民。|(L)|更佳|......|会高兴的|和你一起|真主。|问题|输入|几个|案件|was|罚的骂|标志|upon|宾格吗?|生成|为名词|单数|宾格|四|例子:|其中之一|该名词|单数|宾格|与罚的骂|很明显，|和第二个|该名词|单数|宾格|与罚的骂|应该所隐含，|和第三个|该名词|单数|女性|宾格|与罚的骂|很明显，|他们的第四|该名词|单数|女性|宾格|与罚的骂|应该所隐含。|生成|用复数形式|破碎|宾格|四|示例|不同。|当|使虚拟语气|动词|现在时态|与罚的骂吗?|生成|为动词|现在时态|虚拟语气|两个例子|不同。|用什么|使虚拟语气|动词|现在时态|其中|连接的|与它|阿勒夫|第二个呢?|当|连接的|与结局|动词|现在时态|前所未有|用虚拟语气|中午|重点|那是什么|是其执政吗?|生成|为动词|现在时态|其中|连接的|与它的结局|中午|女性气质|与它之间的自然数|虚拟语气|带有|引用|作出的裁决。
GreatMasterpiece18=替换|阿勒夫|从|罚的骂|它说:|和|阿勒夫|然后是|标志|为宾格|in|名词|五、|就像:|(我见过|你的父亲|和你的兄弟)|和什么|类似|那。|我说:|当然|你知道的|在什么|事先|名词|五、|和条件|拐点|带有 waw|是主格|和阿勒夫|是宾格|和严|是占有，|和现在|我们通知你|与那|标志|该值指示|upon|那|一|其中|单词|都宾格|状态|alef 的|in|它的结局，|就像|(尊重|你的父亲)|并且|(帮助|你的哥哥)|并且|(访问|你的岳父)|并且|(清洁|你的嘴)|并且|(不|尊重|私钥的持有人|财富|因为他的财富)|然后每个|从|(你的父亲，|和你的兄弟，|和你的公公，|和你的嘴|拥有|财富)|in|这些|示例|就像它|是宾格;|所以，它|发生|在它|效果|有了它，|和标志|其宾格的|是 alef|更换|从|罚的骂，|和每个|从它|拥有，|和什么|在它以后|从|kaaf，|并且|(财富)|拥有|到它，|和永远不会|为 alef|箱子|替代品|在它|从|罚的骂|除了|此|案例。|问题|输入|几个|案件|替代品|阿勒夫|从|罚的骂吗?|给|为名词|五|in|条件|宾格的|四|例子。
GreatMasterpiece19=替换|kasra|从|罚的骂|它说:|和|kasra|然后是|标志|为宾格|in|复数|女性|声音。|我说:|当然|你知道的|在什么|事先|复数形式|女性气质|声音，|和现在|我们通知你|它|您可以|那|让证据|upon|宾格|此|复数形式|与存在|kasra|in|它的结局，|和那|就像|你说:|(实在|女孩子们|有礼貌|将达到|荣誉)|然后每个|从|(女孩)|并且|(彬彬有礼):|复数|女性气质|声音，|和两个|是宾格;|因为是|第一|名词|宾格助词的实在，|而且因为是|第二|形容词|宾格|和标志|两个宾格|kasra|更换|从|罚的骂。|永远不会|为 kasra|案例|替代品|在它|从|罚的骂|除了|此|案例。|演习/练习|1-|地方|奇异的女性|给出了|复数|女性|声音|和他们是:|聪明的女人，|法蒂玛，|苏达|女老师，|彬彬有礼的女人，|浴室里，|记忆与记忆。|2-|地方|每个|一|从|复数|女性|给出了|in|一个句子|有意义，|与条件|那|was|in|箱子|宾格|和提供/套|与元音形式/分，|和他们是:|聪明的女性，|Fatimas，|印度教，|女教师，|uvulas，|浴室，|回忆和记忆。|3-|单词|给出了|这是女性的|把/回复|每隔|一|从他们|到|奇异，|然后|地方|这些|单数|复数|女性气质|声音，|和使用|每隔|一|从他们|in|一个句子|有意义，|和他们是:|两个赞，|怀孕了，这两个|每个对两个的作家，|两条消息:|两个女性红色。
GreatMasterpiece20=替换|是啊|从|罚的骂|它说:|和|是啊|然后是|标志|为宾格|in|双|和复数形式。|我说:|当然|你就会知道|双|在什么|过去，|和像那样|当然|你就会知道|复数|男性|声音|和现在|我们会通知你|它|您可以|那|众所周知，|宾格|一个|从这两个|与存在|yah 型|in|它的结局，|与差异|两者之间|那|是啊|in|双|was|什么|在它之前|有罚的骂|和什么|在它以后|有 kasra，|和严|in|复数|男子气概|was|什么|在它之前|有 kasra|和什么|在它以后|有罚的骂。|然后示例|双|(我看着|两个麻雀，|上方|树上)|就像|(买了|我的父亲|两本书|其中之一|对我来说|和其他|为我的弟弟)|然后每个|从|(两个麻雀)|并且|(两本书)|是宾格|因为|效果|有了它，|标志|其宾格的|是啊|有罚的骂|什么|在它之前是|有 kasra|什么|是在它以后，|因其|是双重的|到中午|偏移量/地点|从|noonation|in|名词|奇异。|和一个例子|复数形式|男子气概|声音|(真正|上帝意识|将实现|快乐|他们的主) 的|和一样:|(我建议|勤劳的工人|专门从事|upon|学习/学习)|然后每个|从|(上帝意识)|并且|(硬工人)|宾格;|因为它|效果|有了它，|和标志|其宾格的|是呀|有 kasra|什么|在它之前是|有罚的骂|什么|是后它;|为此，它是|复数|男子气概|声音，|到中午|偏移量/放|从|noonation|in|中午|奇异。|演习/练习|1-|单词|给出了|是单数形式|他们然后双|他们，每个人都|然后地方|从他们|什么|可以将声音|那|多元化|复数|男性|声音，|和他们是:|默罕默德，|法蒂玛，|· 贝克尔|食肉兽，|这位作家，|老虎，|法官，|选择的之一。|2-|用|每个|双|从|双形式|给出了|in|一个句子|有用|与那时|was|宾格|并提供它|加元音符号|充分，|和他们是:|两个穆罕默德，|两个 Fatimas，|两个 Bakrs，|两只老虎，|两位作家，|两只老虎，|两名法官，|两人拣选的人。|3-|用|每个|一|从|复数|给出了|in|一个句子|有意义|与那时|was|宾格|并提供它|加元音符号|充分，|和他们是:|正确地引导的|伊斯兰法的穆夫提/官方解释者|聪明的那些，|作家，|选择/选择/最喜欢的。
GreatMasterpiece21=替换|删除|中午的|从|罚的骂|它说:|和|删除|中午的|然后是|标志|为宾格|in|动词|五|其中|它主格|与恒常性|中午。|我说:|当然|你知道的|用什么|是事先|什么| Yin|动词|五、|和现在|我们通知你|它|您可以|那|你知道的|宾格|每隔|一|从他们|当|你找到|中午|其中|was|标志|主格的|删除，|和他们的例子|in|条件|宾格的|你说:|(这让我高兴|那|你记住|你的课程)，|和一样:|(它伤害了我|从|那些懒惰的人|那|忽视|in|他们的职责)，|然后每个|从|(你背诵)|并且|(他们忽略了)|是动词|现在时态|宾格|与微粒，|和标志|其宾格的|删除|中午，|waw|所述多个|活动元素|结构|upon|sukoon|in|地方|主格。|像那样|连接的|alef|第二，|就像|(这让我高兴|那|两个你取得的成就|每个梦想两的欲望)|和附加|与阎|解决，|就像:|(它伤害了我|那|你女性忽视|in|你的责任)，|和肯定|你知道的|如何|你活用它们。|演习/练习|1-|用|单词|给出了|主格|有一次，|和宾格|按流量预付费|其他，|in|一个句子|有意义，|和放|与元音符号:|这本书，|纸，|然后笔，|墨水瓶，|老虎，|这条河，|大象，|花园里，|骆驼，|花园，|利润，|良好的举止，|他变得可见/清楚，|真实的妇女，|贞洁的妇女，|母亲，|兄弟们，|女教师，|老师们，|列祖，|你的兄弟，|标志，|男子气概，|这两个朋友，|你的父亲，|朋友们，|信徒，|农民|敬畏上帝，|你们两个站起来，|这两个正在玩。|问题|当|was|kasra|标志|为宾格吗?|当|was|是啊|标志|为宾格吗?|输入|几个|案件|was|删除|中午的|标志|为宾格吗?|生成|为复数形式|女性气质|宾格|两个例子|和活用|一|从两个，|让|动词|五|虚拟语气|三|示例|和活用|一|从他们，|让|为复数|男子气概|声音|宾格|用两个例子，|让|为复数|男子气概|声音|主格|用两个例子，|让|双窗体|宾格|用两个例子，|让|双窗体|主格|用两个例子，|让|动词|五|陈述语气|两个例子。
GreatMasterpiece22=标志|所有格的|它说:|和所有格|三|体征:|kasra，|和呀，|和罚的骂。|我说:|您可以|那|你知道的|这个词|所有格的|当|你找到|在他们|一|从|三|事情:|第一|是 kasra，|它是|原始源|in|所有格，|和第二个|是呀，|第三个|是罚的骂，|和两个|分支|从|kasra|和每个|一|从|这些|事情|三|案例|was|在它，|我们将解释|给你的|其例|详细的|在什么|如下。
GreatMasterpiece23=替换|是啊|从|kasra|它说:|和|是啊|然后是|标志|为所有格|in|三|例:|in|名词|五、|中和|二元性|和复数形式。|我说:|对呀|三|案件|were|in|每隔|一|从他们|该值指示|upon|那|名词|是所有格。|案例|第一:|名词|五、|和肯定|你知道他们，|和你知道|条件|他们的拐点的|用什么|事先，|和那|就像:|(迎接和平 /|upon|你的父亲|在上午|天|天)|就像|(不|提高|你的声音|upon|声音|你的弟弟|大)|就像|(不|执行|爱情|为私钥的持有人|财富|除了|那|was|有礼貌)|然后每个|从|(你的父亲，|和你的兄弟，|拥有|财富)|所有格;|用于输入|这封信|所有格的|在其上，|和标志|其所有格的|是呀，|和 kaaf|in|前两个|代词|处理/第二人，|它是|拥有|到它|结构|upon|罚的骂|in|地方|所有格，|和字|(的财富)|in|该示例|第三个|拥有|到它|此外，|所有格|与 kasra|明显。|案例|第二:|二元性，|和那|就像|(看看|在|两名士兵)，|就像|(迎接和平 /|upon|这两个朋友)|然后每个|从|(两名士兵，|和两个朋友)|所有格;|用于输入|这封信|所有格的|在其上，|和标志|其所有格的|是呀|有罚的骂|什么|在它之前|有 kasra|什么|在它之后，|和每个|从|(两名士兵，|和两个朋友)|双;|为此他们|指示|upon|第二个。|案例|第三:|复数|男子气概|声音，|就像|(我很高兴|带有|Bakrs)，|就像|(我看|在|穆斯林|谦卑)|然后每个|从|(Bakrs，|和穆斯林)|所有格;|用于输入|这封信|所有格的|在他们身上，|和标志|其所有格的|是呀|有 kasra|什么|在它之前|有罚的骂|什么|在它之后，|和每个|从他们|复数|男子气概|声音。|演习/练习|1-|付诸表决|每个|谓词|从|动词|给出了|in|两个句子|were|主格|in|其中之一，|和宾格|in|其他。|他跑，|他建立了，|他打扫，|他骑|他擦去，|他喝，|他点燃。|2-|付诸表决|每个|名词|从|名词|给出了|in|三|句子，|与那时|were|主格|in|其中之一|和宾格|in|第二|和所有格|in|第三，|和集/调整|带有|元音的迹象:|你的父亲，|你的兄弟，|你的牙齿，|这本书，|火车上，|水果，|母亲，|朋友们，|两名学生，|两个男人，|那个士兵，|那个女孩，|你的兄弟，|你的朋友|两名士兵，|这两个男孩，|商人，|玫瑰，|尼罗河|浴/清洗，|活泼，|粗心，|有礼貌。|问题|此培训完成后，受众能够做些什么?|的|案件|其中|were|是啊|在他们|标志|upon|所有格|名词吗?|此培训完成后，受众能够做些什么?|区别是|介于|双|和复数|男子气概|in|条件|所有格吗?|生成|双窗体|所有格的|三|例子吗?|生成|为复数形式|男子气概|所有格|三|示例|也。|生成|为名词|五|三|示例|were|名词|in|每个|一|从他们|所有格。
GreatMasterpiece24=替换|罚的骂|从|kasra|它说:|和|罚的骂|然后是|标志|为所有格|in|名词|其中|非|完全屈折变化。|我说:|为罚的骂|箱子|一|was|标志|upon|所有格|名词的|它是|名词|其中|非|完全屈折变化。|和意义|是它|非|完全屈折变化:|它|非|之前接受|每个对完整的拐点，|它是|noonation，|和名词|其中|非|完全屈折变化|它是:|(这其中|类似于|动词|in|存在|两个原因|中学/分组:|其中之一|returns|到|表达，|和其他|returns|到|意思，|或者|状态|在它|原因|一|常设/带|这个地方|两个的原因)。
GreatMasterpiece25=和原因|其中|是发现|in|名词|该值指示|upon|子群|和他们是|返回|到|意义|第二个|不是|其他比:|第一|正确，|第二|描述性，|它必须|从|状态|之一|从|这两个|原因|in|名词|防止|从|充分的拐点|有理由|存在|两个原因|在它。|和原因|其中|是发现|in|名词|并指示|upon|分组|和是|返回|到|表达式|in|六|情况下，|和他们是:|女性|与其他比|alef，|和非阿拉伯语|与复合施工|和另外|alef 的|到中午，|和规模|动词，|和异常，|和它必须|从|状态|之一|从|这些|原因|带有|状态|适当人选|在它，|和|带有|描述性|然后不|已找到|从它|除了|一|从|三、|和他们是:|添加|alef 的|到中午，|或者|规模|动词，|或者|异常。|然后示例|正确的|带有|女性|与其他比|阿勒夫:|法蒂玛，|和赞，|和哈姆扎。|和实例|正确的|带有|非阿拉伯语:|伊德里斯|雅各的神，|和亚伯拉罕。|和实例|正确的|带有|复合的建设:|阿拉伯的人，|和黎巴嫩的城市，|和著名的科学家统治者判断，|和聪明的波斯语，|和伊朗的城市。|和实例|正确的|带有|添加|alef 的|到中午:|马尔万，|和奥斯曼，|和 Gatfaan/部落主义，|和阿凡，|和 · 萨赫班，|和扬，|和伊姆兰，|和 Qahtan，|和 Adnan。|和实例|正确的|带有|规模|动词:|Ahmad/表扬，|和 Yashkur/谢谢你，|和 Yazeed/增加，|Taglib/克服，|和穆尔/销毁。|和实例|正确的|带有|异常:|欧麦尔|和 Zufar/教法的科学家，|和 Qutham，|和偶像，|与土星，|和部落主义，|和彩虹，|和流氓。|和实例|描述性|带有|添加|alef 的|到中午:|精心浇灌，|和全/满意，|和醒来周到。|和实例|描述性|带有|规模|动词:|越高贵，|更好，|而更美丽。|和实例|描述性|带有|异常:|三三两两 / 双，|和第三 / 三五成群，|和第四次 / 四脚着地，|和其他人。|和|两个原因|其中|柜|每个|一|从这两个|这个地方|两个原因|然后这两个是:|公式/模式|结局的|复数，|阿勒夫|女性|有限|或者|扩展。|对于|公式/模式|结局的|复数|然后是它的一般规则:|那|was|名词|复数形式|坏了，|和肯定|发生|之后|阿勒夫|其破碎|两封信|就像:|清真寺，|和讲坛/酒水，|更好，|更尊贵，|和更接近于完美/更多类似/像，|和不舒服/来月经，|和不舒服/来月经，|或者|三|字符|它的中间|元音-少，|就像:|一把钥匙|和麻雀，|和蜡烛/灯。|和|阿勒夫|女性|有限|然后就像:|怀孕了，|和大多数，|和世界，|和索赔。|和|阿勒夫|女性|扩展|然后就像:|红色，|和黑色的大眼睛的女性，|和美丽，|和白色的|和黑色的眼睛，|和隧道，|和科学家。|然后每个|什么|我们已经提到过|从|这些|名词，|和喜欢|什么|看起来好像，|非|允许|其 tanween|和使所有格|与罚的骂|更换|从|kasra，|就像:|(称呼|真主|安宁|亚伯拉罕 ·|他的朋友)|和一样:|(可能是高兴|真主|带有|欧麦尔|主持人|信徒):|然后每个|从|亚伯拉罕 ·|和欧麦尔:|所有格;|用于输入|信件|所有格的|在其上，|和标志|他们两个的所有格的|罚的骂|更换|从|kasra|为此|每个|一|从这两个|一个名词|非|完全屈折，|和预防|从|充分的拐点|亚伯拉罕的|是正确的|非阿拉伯语|和预防|从|充分的拐点|欧麦:|正确|与异常。|等|upon|那|剩下的人。|和所需|为所有格|名词|其中|非|完全屈折变化|与罚的骂:|那|was|空闲|从|(粒子)|而不是|连接的|到|名词|在它之后，|然后如果|再加上|与的粒子|或者|已添加|所有格|与 kasra，|就像|它说:|最高|(和你|专门讨论|in|清真寺|)(2:187)|和一样:|(我通过|由美丽的女人|商队的)。|演习/练习|1-|请参阅|原因|其中|是新任|防止|充分的拐点|in|每个|Word|从|单词|给出:|赞，|流氓，|约瑟夫，|亚伯拉罕，|更尊贵|于|Ahmad，|黎巴嫩的城市，|充满了水，|挂锁，|Hassan，|阿舒拉节，|世界。|2-|付诸表决|每个|Word|从|单词|给出了|in|两句话，|与那时|was|in|两个之一|所有格|与罚的骂|更换|从|kasra，|中和|第二|所有格|与 kasra|明显。|黑色的大眼睛的女性，|接近完美/更多类似的/象，|比，更美丽|保持警惕。|3-|付诸表决|in|这个地方|自由/空|从|这句话|给出了|一个名词|防止|从|充分的拐点|并将其设置|与元音的迹象，|然后|请参阅|原因|in|其预防:|(裁决)|游记|......|带有|你的哥哥。|(B)|......|是更好|于|......|(C)|有了|带有|......|访客|从|......|(代理)|这座清真寺|Amr/领袖的|是老|什么|在埃及|于|......|(E)|这|女孩|......|(F)|......|出现|之后|雨中。|(G)|我通过|由一个饥饿的穷人|......|所以我给了捐赠慈善机构 /|给他。|(H)|给予施舍/善良|到|有害/施虐者|......|为到|安全的救。|() i|......|我们有同情/感情用事|为后|穷人。|问题|此培训完成后，受众能够做些什么?|的|案件|其中|were|罚的骂|在他们|标志|在|所有格|名词吗?|和什么|意思是|was|名词|非|完全屈折变化吗?|此培训完成后，受众能够做些什么?| Yin|名词|其中|非|反映吗?|此培训完成后，受众能够做些什么?| Yin|原因|其中|returns|到|的意思吗?|此培训完成后，受众能够做些什么?| Yin|原因|其中|returns|到|表达吗?|几个|原因|从|原因|表达式|被发现|带有|软糖吗?|几个|原因|从|原因|表达式|被发现|带有|国际音标吗?|此培训完成后，受众能够做些什么?|是两个|原因|其中|站/加注|一|从这两个|一个地方|两个原因吗?|生成|为一个名词|非|完全屈折变化|是否存在|正确的|与异常，|和描述性|与异常，|和适当的|和另外|alef 的|到中午，|和描述性|和另外|alef 的|到中午，|和适当的|和女性，|和描述性|和规模|动词，|和适当的|和非阿拉伯语。
GreatMasterpiece26=标志|命令的心情|它说:|和其命令的理由|两个标志:|苏坤|和删除。|我说:|它是可能|那|作出裁决|upon|这个词|与那|是命令案例|当|已找到|在它|一|从|两件事;|第一:|苏坤|它是|标志|原始|为命令的情况下，|和第二个:|删除，|它是|标志|中学，|和每个|一|从|这两个|标志|是的地方|我们会提醒他们|给你的|在什么|如下所示:
GreatMasterpiece27=这个地方|苏坤的|它说:|然后为|苏坤|然后它是|标志|命令的理由|in|动词|存在|声音|结束。|我说:|为苏坤|第一|地方| Yin|在它|标志|upon|那|Word|命令的心情，|与此|地方|它是|动词|存在|声音|结局，|和意义|正在|声音|结束|那|它的结局|不是|其信|从|字符|缺陷|三|其中|的|阿勒夫|和 waw|和严。|和实例|动词的|存在|声音|结束|(他戏剧|和他成功|和他的旅行|和他的承诺|和他问)|然后当|你说:|(没有|播放|阿里)|并且|(没有|成功/通|愚蠢的人)|并且|(没有|传播|你的哥哥)|并且|(没有|承诺|亚伯拉罕 ·|对哈立德|与任何东西)|并且|(没有|问|巴克尔|给老师)|然后每个|从|这些|动词|是命令的情况下，|前|粒子|命令的情况下|其中| Yin|(没有)|在其上，|和标志|其命令的案件|是苏坤|和每个|一|从|这些|动词|是一个动词|存在|声音|结局。
GreatMasterpiece28=地方|删除的|它说:|和|删除|它是|标志|为命令|in|动词|存在|弱|结局|中和|动词|五|其中|它指示|切除|中午。|我说:|删除|两个地方|的|in|每个|一|从两|标志|和一个标志|upon|命令|这个词。|这个地方|第一:|动词|存在|弱|结局，|和意义|正在|弱|结局|那|它的结局|信件|从|字符|有缺陷|三|其中|的|阿勒夫|和 waw|和严。|然后该示例|动词的|存在|其中|它的结局|是 alef|(他奋斗，|和他接受，|和他爱/而变得喜欢，|和他很远，|而且他仍然)|和示例|动词的|存在|其中|它的结局|是 waw|(他的电话/supplicates，|他希望，|和他的测试中，|他是高|和他是残酷的|和他是远了)|和示例|动词的|存在|其中|它的结局|是呀|(他给，|和他的法官，|他的封面，|他赐生命，|和他轮流/曲线，|和他指导)|然后当|你说:|(没有|奋斗|阿里|toward|荣誉)|然后如果|(他求)|命令的心情;|为前|粒子|命令|在其上，|和标志|其命令的|删除|alef 的|和罚的骂|在它之前|标志|在其上，|它是|动词|存在|弱|结局，|和什么时候|你说:|(没有|呼叫|默罕默德|除了|到|真相)|然后如果|(电话)|谓词|存在|命令的心情;|因为之前|粒子|命令|在其上，|和标志|其命令的|删除|waw 的|和 damma|在它之前|该值指示|在其上，|和什么时候|你说:|(没有|让|默罕默德|除了|对哈立德)|然后如果|(给)|一个动词|存在|命令的心情|因为之前|粒子|命令|在其上，|和标志|其命令的|删除|呀，|和 kasra|在它之前|该值指示|在其上，|寻求|upon|那|及其同伙。|这个地方|第三:|动词|五|其中|仅供参考|与证明|中午，|和肯定|之前|与它的声明，|和它的例子|(两个男性节拍，|和两个女性 / 你两个的男性/女性节拍，|他们男性打，|和你所有男性打，|和你女性打败)|和你说|(没有|两个男性节拍，|也没有|两个女性 / 你两个的男性/女性节拍，|也没有|他们阳刚击败，|也没有|你所有男性打，|也没有|女性的打)|为每个|一|从|这些|动词|是一个动词|存在|命令的心情;|因为之前|粒子|命令|其中|它是|(没有)|在其上，|和标志|其命令的|是删除|中午，|和阿勒夫|或者|waw|或者|叶|活动元素的|结构|upon|苏坤|in|地方|指示性。|演习|1-|用|每个|谓词|从|动词|给出了|in|三|句子|有意义，|所以| Yin|in|每个|一|从他们|陈述语气，|中和|第二|虚拟语气|中和|第三|命令的心情，|和放|与词根|完成|in|每个|句子:|他打了，|你们两个帮忙，|你女性的旅行，|他就在附近，|所有男性你赢了，|他买了，|他依然，|他们两个在前面。|2-|付诸表决|in|地方|空闲|从|这句话|给出了|谓词|存在|虚拟语气，|然后|参考|标志|它的拐点:|(裁决)|懒惰的人|......|到|他自己|和他的祖国。|(B)|从不|......|荣誉|除了|艰苦的工作|和毅力。|(C)|朋友|真诚|......|为幸福|他的朋友。|(代理)|两个女孩|勤劳的工人|......|他们的父亲。|(E)|学生|光荣|......|他们的国家。|(F)|您|哦我的朋友|......|与您的光临。|(G)|开始时间|事迹|好|真的是他|......|(H)|If|伤害你人|某些|你的兄弟的|然后不|......|() i|我很高兴|那|......|你的兄弟。|(J)|If|你做你|工作|......|(K)|没有|......|我的父亲|昨天。|(L)|您|哦赞|......|你的责任。|(M)|If|你来看我|......|(N)|无论|您已隐藏|......|问题|此培训完成后，受众能够做些什么?|的|标志|命令吗?|输入|几个|位置| Yin|苏坤|标志|为命令吗?|输入|几个|位置| Yin|删除|标志|upon|命令吗?|此培训完成后，受众能够做些什么?| Yin|谓词|声音|结局吗?|生成|为动词|声音|结局|十|例子，|什么| Yin|谓词|有缺陷|结局吗?|生成|为动词|有缺陷|其中|它的结局|alef 的|与五|例子，|和像那样|动词|其中|它的结局|waw 的|闭合|为动词|其中|它的结局|yah 型|用两个例子，|什么|的|动词|五个吗?|用什么|使命令|动词|五个吗?|生成|动词|五|命令的情况下|与五|例子。
GreatMasterpiece29=屈折变化|它说:|(司)|屈折变化|分为两个部分:|部分|屈折变化|与元音的迹象，|和部分|屈折变化|用字母。|我说:|想要|作者|-|可能是他满意|真主|最高|-|有了这些|部门|那|是指|upon|总结的方式|其中，|这项裁决|什么|以前|它阐述了|in|地方|拐点，|地位和身份|其中|以前|提到了|他们的裁决|in|拐点|拟订|八、|和他们是:|名词|奇异，|和复数|破碎的|和复数|女性|声音，|和动词|现在时态|其中|非|连接的|与它的结局|任何事情，|和双，|和复数|阳刚气|声音，|和名词|五、|和动词|五、|和这些|种类|-|其中|的|位置|拐点|-|划分|into|两个部分:|第部分|第一个|屈折变化|与元音的迹象，|第部分|第二个|屈折变化|用字母，|和如下|一种解释|每个|部件|从这些|阐述了。
GreatMasterpiece30=屈折变化|与元音迹象|它说:|然后，|屈折变化|与元音迹象|四|事情:|名词|奇异，|和复数|破碎的|和复数|女性|声音，|和动词|现在时态|其中|非|已连接|与它的结局|所有的东西。|我说:|元音迹象|有三个，|和他们是:|damma，|和罚的骂，|和 kasra，|并将追加|与他们|苏坤|和肯定|你知道的|那|屈折变化|都注视着|两个部分:|部分|屈折变化|与元音的迹象，|和部分|屈折变化|用字母|和那|开始|in|解释|第部分|第一个|其中|反映|与元音的迹象，|它是|四|事情:|1-|名词|奇异，|和它的例子|(穆罕默德)|并且|(课)|从|你说:|(还记得|默罕默德|这一课)|然后记得:|一个动词|过去式|结构|upon|罚的骂|非|一个地方|为它|从|屈折变化，|和默罕默德:|活动元素|主格，|和标志|它主格的|是 damma|很明显，|和经验教训:|对象|与它|是宾格|和标志|其宾格的|是罚的骂|很明显，|和每个|从|(穆罕默德)|并且|(课)|是一个名词|奇异。|2-|复数形式|破碎的|和它的例子|(学生)|并且|(教训)|从|你说:|(记得|学生|经验教训)|然后记得:|一个动词|过去式|结构|upon|罚的骂|非|一个地方|为它|从|屈折变化，|学生:|活动元素|主格|和标志|它主格的|damma|很明显，|经验教训:|作用|在上面|宾格|和标志|其宾格的|罚的骂|很明显，|和每个|从|(学生，|和经验教训)|复数|破碎) 的|3-|复数形式|女性气质|声音，|和它的例子|(相信妇女)|并且|(祈祷)|从|你说:|(担心|相信妇女|in|祈祷)|当时担心:|一个动词|过去式|结构|upon|罚的骂|非|一个地方|为它|从|屈折变化，|相信妇女:|活动元素|主格|和标志|它主格的|damma|很明显，|中和|粒子|所有格，|祈祷:|所有格|同在|和标志|其所有格的|kasra|很明显，|和每个|从|(相信妇女，|并为他们祈祷)|复数形式|女性气质|声音。|4-|动词|存在|其中|非|连接的|与它的结局|任何事情，|和它的例子|(他走)|从|你说:|(到了。|默罕默德)|然后他去:|一个动词|存在|陈述语气|为其免费|从|虚拟语气|与命令，|和标志|它指示性的|damma|很明显，|和默罕默德|活动元素|主格|和标志|它指示性的|damma|明显。
GreatMasterpiece31=起源|在|拐点|这其中|是屈折|与元音的迹象，|和什么|被排除在外|从他们|它说:|和他们每个人都|由主格|与 damma，|和做宾格|与罚的骂，|和做的所有格|与 kasra，|和作出的命令|与苏坤，|和失散|从|那|三|事情:|复数形式|女性气质|声音|作宾格|与 kasra，|和名词|其中|非|充分 inflectable|是由所有格|与罚的骂，|和动词|存在|连接的|它的结局|命令|与删除|它的结局。|我说:|起源|in|事情|四|其中|活用|与元音符号:|那|反映|与 damma|和做宾格|罚的骂，|和做的所有格|与 kasra，|和作出的命令|与苏坤。|然后为|主格|与 damma|然后真正|他们每个人都|当然|来了|upon|什么| Yin|起源|在他们，|然后主格|其复数形式的|与 damma，|和它的例子:|(游记|默罕默德|和朋友|并相信妇女)|然后旅行:|一个动词|存在|陈述语气|为其免费|从|虚拟语气|与命令，|和标志|它主格的|damma|很明显，|它是|一个名词|奇异，|和朋友们:|主格|因其|合取|upon|主格，|和标志|它主格的|是 damma|很明显，|它是|复数|破碎的|并相信妇女:|主格;|因其|还|合取|upon|主格，|和标志|它主格的|damma|很明显，|它是|复数|女性气质|声音。|和|宾格|与罚的骂|然后当然|他们每个人都|来了|upon|什么| Yin|起源|在它，|什么|除了|复数形式|女性气质|声音，|然后当然它|让宾格|与 kasra|更换|从|罚的骂，|它的例子:|(不会的|反对|默罕默德|和朋友们|并相信妇女)|然后反对:|一个动词|存在|虚拟语气|将不，|和标志|其虚拟语气的|罚的骂|很明显，|和默罕默德|作用|与它|宾格|和标志|其宾格的|罚的骂|表观|此外，|它是|一个名词|单数|就像|它表明，|和朋友们:|宾格|因其|合取|upon|宾格|和标志|其宾格的|罚的骂|表观|此外，|它是|复数|破碎的|就像|它表明，|相信妇女|宾格|因其|是合取|upon|宾格|此外，|和标志|其宾格的|kasra|更换|对于|罚的骂，|因其|复数|女性气质|声音。|和|所有格|与 kasra|然后确实|他们的每个|当然|来了|upon|什么| Yin|起源|在它，|那|除了|动词|现在时态|然后当然它|非|使得所有格|起源，|和那|除了|名词|其中|非|充分反映，|然后当然它|反映|与罚的骂|更换|从|kasra，|和它的例子:|(我通过|由穆罕默德，|和男人，|相信妇女，|和 Ahmad)|然后我通过:|动词|和积极的元素，|和呸|一个粒子|所有格，|和默罕默德:|所有格|与呸，|和标志|其所有格的|kasra|很明显，|它是|一个名词|单数|完全屈折变化|就像|你明白，|和男人:|所有格，|因其|是合取|upon|所有格，|和标志|其所有格的|kasra|很明显，|它是|复数|破碎的|充分 inflectable|就像|你理解|此外，|并相信妇女:|所有格，|因其|合取|upon|所有格|此外，|和标志|其所有格的|kasra|很明显，|它是|复数|女性气质|声音|就像|你理解|此外，|和 Ahmad:|所有格，|因其|是合取|upon|所有格|此外，|和标志|其所有格的|罚的骂|更换|从|kasra，|因其|是一个名词|非|充分 inflectable，|和预防|为它|从|拐点|专有名词|和规模|动词。|和|命令|与苏坤|然后你|知道|那|命令|指定|与动词|目前，|然后如果|were|声音|结局|然后如果|其命令|与苏坤|就像|它是|起源|in|命令，|和它的例子:|(没有|传播|哈立德)|然后没有:|一个粒子|否定之否定|和的命令|和的复分解反应/更改，|和旅行:|一个动词|现在时态|命令的心情|与没有，|和标志|其命令的|苏坤|和哈立德:|活动元素|主格，|和标志|它主格的|damma|很明显，|如果|was|动词|现在时态|连接的|它的结局|was|其命令|与删除|这封信的|有缺陷，|和它的例子:|(没有|奋斗|· 贝克尔|也没有|他呼叫/邀请，|也没有|执行|这是|他)|然后每个|从|(努力，|和电话/邀请，|和执行)|一个动词|现在时态|命令的心情|与没有，|和标志|其命令的|删除|alef 的|从|(努力)|和罚的骂|在它之前|标志|在其上，|和删除|waw 的|从|(调用/邀请)|和 damma|在它之前|标志|在其上，|和删除|yah 型|从|(执行)|和 kasra|在它之前|标志|在上面。
GreatMasterpiece32=屈折变化|用字母|它说:|而|反映|用字母|四|类型:|双，|和复数|男子气概|声音，|和名词|五、|和动词|五、|和他们是:|他们两个男性做，|和他们两个女性你们两个做|他们所有男性这样做，|所有男性的你，|和女性的你。|我说:|第部分|第二个|从|屈折变化:|事情|其中|活用|用字母，|字母|其中|were|标志|upon|词形变化|四、|和他们是:|阿勒夫|和 waw|和呀，|到中午，|和那的|反映|有了这些|字符|四|事情:|1-|二元性，|和预期|与它|双，|和它的例子:|(两个国家，|和两个穆罕默德，|和两个 Bakrs，|和两个男人)|2-|复数形式|男子气概|声音，|和它的例子:|(穆斯林，|Bakrs，|穆罕默德)|3-|名词|五|和他们是:|(你的父亲，|和你的兄弟，|和你的岳父大人，|和你的嘴，|和拥有|财富)。|4-|动词|五|和他们的例子:|(两名男子袭击，|和这两个女人 / 你两个写/订明，|和他们所有的人明白，|和你所有的人保留/背诵，|你女性是花不眠/晚上/唤醒)。|会给你|示威活动|拐点|每个|一|从|这些|事情|四|在详细信息。
GreatMasterpiece33=拐点|双|它说:|然后为|二元性|然后你让主格|alef|你让宾格|和使所有格|与严。|我说:|第一|从|事情|其中|活用|用字母|(二元)|和它是:|双|就像|你知道的|和肯定|你理解|在什么|上一页|你明白|双。|和其裁决:|那|你使主格|alef|更换|从|damma，|和使宾格|和使所有格|与阎|有罚的骂|什么|在它之前是|有 kasra|什么|在它之后是|更换|从|罚的骂|或者|kasra，|并继续|与它|之后|阿勒夫|或者|是啊|中午| Yin|替代|从|noonation|其中| Yin|in|名词|奇异，|而不是|被删除|此|中午|除了|从|拥有在所有格的建设。|然后示例|双|主格|(出席|两名法官，|说:|两个男人)|然后每个|从|(两名法官)，|并且|(两人)|主格|因其|是活跃的元素，|和标志|它主格的|阿勒夫|更换|从|damma，|因其|是双重的|中午|替代品|从|noonation|in|名词|奇异。|和一个例子|双的|宾格|(我爱|这两个彬彬有礼，|我不喜欢|两个懒/懒惰的人)|然后每个|从|(彬彬有礼的两个)|并且|(两个懒惰/懒惰)|宾格|因其|作用|在其上，|和标志|其宾格的|是呀|与罚的骂|什么|在它之前是|与 kasra|什么|在它之后是|更换|从|罚的骂，|因其|是双重的|到中午|替代|从|noonation|in|名词|奇异。|和一个例子|双|所有格|(我看|在|两个骑兵|打开|两匹马)|然后每个|从|(两个骑兵)|并且|(那两匹马)|所有格，|用于输入|颗粒|所有格的|到它，|和标志|其所有格的|是啊|与罚的骂|什么|在它之前是|与 kasra|什么|在它之后是|更换|从|kasra，|因其|是双重的|到中午|替代|从|noonation|in|名词|奇异。
GreatMasterpiece34=拐点|复数形式|男子气概|声音|它说:|和|复数|男子气概|声音|然后它使主格|带有 waw|和使宾格|和使所有格|与严。|我说:|第二|从|事情|其中|活用|用字母|(复数形式|男子气概|声音)|和肯定|你知道的|在什么|上一页|意思|复数|男子气概|声音。|和其裁决:|那|使得主格|带有 waw|更换|从|damma|和使宾格|和使所有格|与阎|与 kasra|什么|在它之前是|与罚的骂|什么|在它之后是|更换|从|罚的骂|或者|kasra，|它会继续|与它|之后|waw|或者|是啊|中午| Yin|替代|从|noonation|in|名词|奇异，|和删除|这|中午|带有|在拥有建设拥有|像中午|双。|然后示例|复数形式|男性|声音|主格|(出席|穆斯林)|并且|(成功|指挥官|这是好的)|然后每个|从|(穆斯林)|并且|(指挥官)|主格|因其|活动元素|和标志|它主格的|waw|更换|从|damma|因其|复数|男子气概|声音，|到中午|是一个替代品|从|noonation|in|名词|奇异。|和一个例子|复数形式|男子气概|声音|宾格|(我见过|穆斯林)|并且|(我尊重|指挥官|这是好的)|然后每个|从|(穆斯林)|并且|(指挥官)|宾格;|因其|作用|在其上，|和标志|其宾格的|是啊|与 kasra|什么|在它之前是|与罚的骂|什么|是后它;|因其|是复数|男子气概|声音，|到中午|替代|从|noonation|in|名词|奇异。|和一个例子|复数形式|男子气概|声音|所有格|(与我一同参加|与指挥官|这是好的)|并且|(可能是高兴|真主|带有|信徒)|然后每个|从|(指挥官)|并且|(信徒)|所有格，|用于输入|粒子|所有格的|对此，|和标志|其所有格的|是啊|与 kasra|什么|在它之前是|与罚的骂|什么|是在它以后，|因其|复数|男子气概|声音，|到中午|替代|从|noonation|in|名词|奇异。
GreatMasterpiece35=拐点|名词的|五|它说:|和|名词|五|然后它使主格|带有 waw，|和使宾格|alef，|和使所有格|与严。|我说:|第三|从|事情|其中|活用|用字母|(名词|五)|和肯定|上一页|它指出|并引用|条件|其拐点的|此|拐点。|和其裁决:|那|它使主格|带有 waw|更换|从|damma，|和使宾格|alef|更换|从|罚的骂|和使所有格|与阎|更换|从|kasra。|然后示例|名词的|五|主格|(如果|命令你|你的父亲|然后服从他)|并且|(到达|你的兄弟|从|他的旅行)|然后每个|从|(你的父亲)|并且|(你的兄弟)|主格，|然后为它|是活跃的元素，|和标志|它主格的|waw|更换|从|damma，|因其|是从|名词|五、|和 kaaf|拥有|到它，|结构|upon|罚的骂|in|一个地方|所有格。|和一个例子|名词的|五|宾格|(服从|你的父亲)|并且|(爱|你的哥哥)|然后每个|从|(你的父亲)|并且|(你的兄弟)|宾格|因其|代理|在其上，|和标志|其宾格的|阿勒夫|更换|从|罚的骂，|因其|是从|名词|五、|和 kaaf|拥有|到它，|结构|upon|罚的骂|in|所有格，|正如|以前。|和一个例子|名词的|五|所有格|(听着|到|你的父亲，|同情/关注|与关于|你的哥哥)|然后每个|从|(你的父亲)|并且|(你的兄弟)|所有格，|用于输入|粒子|所有格的|在其上，|和标志|其所有格的|是啊|更换|从|kasra，|因其|是从|名词|五、|和 kaaf|拥有|到它|正如|以前。
GreatMasterpiece36=拐点|动词的|五|它说:|和|动词|五|然后它使陈述语气|中午，与|和使虚拟语气|和使命令心情|删除它。|我说:|第四|从|事情|其中|活用|用字母|(动词|五)|和肯定|你理解|在什么|上一页|真正的意义|动词的|五。|和其裁决:|它|让陈述语气|加|中午的|更换|从|damma，|和使虚拟语气|和使命令心情|与删除|这|中午|更换|从|罚的骂|或者|苏坤。|然后示例|动词的|五|陈述语气|(这两个女人 / 你们俩写)|并且|(这两个女人你们两个，理解)|然后每个|从他们|一个动词|现在时态|陈述语气，|剥离|从|虚拟语气|与命令，|和标志|它指示性的|添加|中午，|和阿勒夫|代词的|第二人|活跃的元素，|结构|upon|苏坤|in|地方|指示性。|和一个例子|动词的|五|虚拟语气|(不会的|这两个女人 / 两个可以伤心)|并且|(不会的|这两个女人 / 你们两个失去勇气)|然后每个|从这两个|一个动词|现在时态|虚拟语气|将不，|和标志|其虚拟语气的|删除|中午，|和阿勒夫|代词的|第二人|活动元素|结构|upon|苏坤|in|地方|指示性。|和一个例子|动词的|五|命令的心情|(没有|这两个女人 / 两个你学习)|并且|(没有|这两个女人你们两个，理解)|然后每个|从这两个|一个动词|现在时态|命令的心情|与没有，|和标志|其命令的|删除|中午，|和阿勒夫|代词的|第二人|活动元素|结构|upon|苏坤|in|地方|指示性。|演习/练习|1-|付诸表决|每个|Word|从|单词|给出了|in|一个句子|有意义|位置|它是|宾格|和是指|标志|它的宾格:|天气，|灰尘，|路|那根绳子，|燃烧，|棉花，|学校，|两个穿着，|真诚致力，|穆斯林妇女，|我的父亲，|殿下，|满意。|2-|付诸表决|每个|Word|从|单词|给出了|in|一个句子|有意义，|位置|它是|所有格，|和是指|标志|它的所有格:|你的父亲，|有礼貌，|坚定|在他们的义务，|野兽的祈祷，|Ahmad，|一轮/圆，|门，|这两个棕榈树，|两只老鼠，|法官，|人类。|3-|付诸表决|每个|Word|从|单词|给出了|in|一个句子|有意义，|位置|它是|主格，|和是指|标志|它主格:|其父母/父亲和母亲，|和平的使者，|指南 》，|战士/夺宝奇兵|列祖，|母亲，|剩下的人，|我的儿子，|你的哥哥。|4-|请参阅|in|标志|给出了|语气|和虚拟语气|和命令的心情|从|动词，|和主格|和宾格|和所有格|从|名词，|并引用|带有|每个|一|标志|它的拐点:|咨询/飒飒忠告|欧麦尔|儿子|仆人|全能的上帝|in|人员|他雇用，|然后说:|给他|某些|他的朋友们:|你你身上使使用|与人民|责任，|和他说:|和谁|它们吗?|他说:|那些|If|他们只是|然后它是|什么|你曾希望，|如果|他们落在后面/过失无法|说|人:|当然|努力工作|欧麦尔。|带来了|拉希德|一个男人|要负责的|判断，|然后说:|对他说:|事实上|非|我很好|在判断|而不是|I|是法理，|然后说:|(罗恩 ar-)拉希德:|在你|是三个|特征/属性:|给你|贵族|和贵族|防止|自己|从|被卑鄙平均值，|和为你|忍耐/忍耐|它可以防止你|从|时间仓促|和他的人|没有|加速|有较少|错误。|5-|你是|一个男人|咨询/寻求咨询|in|您的建议/事项，|和谁|寻求意见|更多|这是正确的|至于|伊斯兰法理学|它同伙子公司|给你|与他的人|你学习|有了它，|所以被关闭或朋友|所以不|他们发现|在它|一个地方的攻击，诽谤，坏事。|5-|使在对偶形式|单词|给出，|然后|使用|每隔|双|in|两个句子|有意义|因此|它是|in|一|从|这两句话|主格，|和第二个|所有格。|墨水瓶，|父亲，|花园里，|这支笔，|这本书，|国家，|该研究所。|6-|使的复数形式|单词|给出了|复数|男性|声音，|和使用|每个|复数|in|两个句子|有意义|与条件|那|它是|主格|in|这两个第一|和宾格|in|其他:|义人，|研究，|懒惰的人，|虔诚的/上帝意识，|满意，|默罕默德。|7-|付诸表决|每个|谓词|从|动词|现在时态|给出了|in|三|句子|有意义，|与条件|那|它是|陈述语气|in|其中第一种，|和虚拟语气|in|第二，|和命令的心情|in|第三:|他的戏剧，|他做|他的职责，|他们是疲倦/累/越来越无聊，|你女性参加，|他的希望|奖励，|两个旅行。|问题|自|几个|部件|被划分|屈折变化吗?|此培训完成后，受众能够做些什么?| Yin|屈折变化|其中|反映|与元音的迹象吗?|此培训完成后，受众能够做些什么?| Yin|屈折变化|其中|反映|用字母，|做例子|该名词|单数|充分 inflectable|in|条件|主格的|和宾|和所有格，|并举例说明|为复数形式|破碎的|诸如此类。|用什么|让宾格|复数形式|女性气质|听起来吗?|做例子|为复数形式|女性气质|声音|in|条件|宾格的|和所有格。|用什么|使得所有格|名词|其中|非|是充分 inflectable 吗?|做例子|该名词|其中|非|是充分 inflectable|in|条件|所有格的|和主格|和宾格。|用什么|使命令心情|动词|现在时态|已连接|结局吗?|做例子|为现在时态|已连接|结局|in|条件|命令。|此培训完成后，受众能够做些什么?| Yin|屈折变化|其中|反映|用字母吗?|与什么|使得主格|双吗?|与什么|让宾格|和使所有格吗?|用什么|使得主格|复数形式|男子气概|听起来吗?|与什么|让宾格|和使所有格吗?|让例子|为复数形式|男子气概|声音|诸如此类。|用什么|你理解吗|名词|五|in|条件|主格的|和宾?|与什么|这让所有格吗?|做例子|为名词|五|in|条件|主格的|和宾格|让例子|动词|五|in|条件|三。
GreatMasterpiece37=动词|与它种|它说:|(章|动词)|动词|有三个:|过去时态，|和现在时态|和命令紧张|就像:|他打了，|和他打吗，|和命中。|我说:|被划分|动词|into|三|部件:|第部分|第一:|过去时态，|它是|什么|被表示|upon|获取|事情|之前|时间|演讲，|就像:|(他打了，|和他帮助的所协助的|他开了，|他知道，|他认为/认为，|和他很大方)。|第部分|第二:|目前的紧张，|它是|什么|被表示|upon|获取|事情|in|时间|演讲，|或者|在它之后，|就像:|(他命中，|和他帮助/次助攻，|他打开|他知道，|他认为/认为，|他是慷慨)。|和部分|第三:|命令紧张，|它是|什么|如下|与它|获取|事情|之后|时间|演讲，|就像:|(命中，|并帮助或协助，|和开放，|知道，|想想/认为，|和慷慨)。|肯定|我们提醒|给你的|in|开始|这本书的|这些|部分，|我们提醒|给你的|与它|标志|天|部件|从|这些|部件|三。
GreatMasterpiece38=裁决|动词的|它说:|过去时态:|与罚的骂|结局|总是，|和命令紧张|命令|总是，|和现在时态|什么|was|in|它的第一|一|增加的内容|四|其中|当加入到它的时候|你可以说:|(tah、 中午、 阎喉塞音符)|它是|主格|总是，|直到|进入|在上面|虚拟语气|或者|命令。|我说:|之后|那|是指|作者|类型|动词的|开始|in|解释|规则/法律|天|种类|从它。|当时的执政党|动词的|过去时态|是构建/固定|upon|罚的骂，|与此|罚的骂|作为为|可见/明显，|至于|应该。|对于|罚的骂|可见|然后在|声音|结束|其中|没有|附加|与它|waw|复数形式，|而不是|代词|主格|移动电话|诸如此类|in|每个|什么|was|它的结局|waw|或者|是啊，|就像:|(我感到很荣幸，|他介绍，|他旅行时)，|和一样:|(旅行|赞，|和参加|萨阿德)|和一样:|(他是高兴的所满意的|和他不高兴)，|和一样:|(他是光荣/高贵，|而且他用淫秽下流的语言)。|和|罚的骂|隐藏本应|然后它是|upon|三|类型:|因其|作为为|那| Yin|应该|为不可能的事，|与此|in|每个|什么|was|它的结局|alef，|就像:|(他称为/恳求，|和他奋斗)|然后每个|从这两个|是动词|现在时态|结构|upon|罚的骂|应该|upon|阿勒夫|防止|从|其明显|不是可能，|至于|那| Yin|罚的骂|应该|适合适当性 /|和那|in|每个|谓词|过去时态|连接的|与它|waw|所述多个，|就像:|(他们写道:|他们是快乐的)|然后每个|从这两个|一个动词|过去时态|结构|upon|罚的骂|应该|upon|它的结局|防止|从|其明显|运作|在的地方|元音的迹象|适当的/合适，|和 waw|所述多个|带有|每个|从这两个|活动元素|结构|upon|苏坤|in|一个地方|指示性，|至于|那| Yin|罚的骂|应该|为连续|添加后缀|在继承|四|元音字母，|和那|in|每个|谓词|过去时态|连接的|与它|代词|主格|移动，|像 tah|活动元素|到中午|女性的特质，|就像:|(写道，|你阳刚写道:|你女性写道:|我们写道:|她写了)|然后每个|一|从|这些|动词|一个动词|过去时态|结构|upon|罚的骂|应该|upon|它的结局|防止|从|其明显|运作|在的地方|苏坤的|参展商/占领|为连续|添加后缀|在继承|四|元音|在什么| Yin|像这个词|一个人，|和 tah|或者|(我们)|或者|中午|是有源元件|结构|upon|damma|或者|罚的骂|或者|kasra|或者|苏坤|in|一个地方|主格。|和执政的|动词的|命令的时态:|结构/无词形变化的结局|upon|什么|是由命令案例|与它|在其现在时态。|然后如果|was|它现在时态|声音|它的结局，|它使命令案例|与苏坤，|was|该命令|结构|upon|苏坤|与此|苏坤|作为为|很明显，|至于|应该，|然后苏坤|表观|为它|两种情况下，|其中第一种:|那| Yin|声音|它的结局的|也没有|附加|与它|任何事情，|和第二个:|那|高度重视|与它|中午|女性气质|就像:|(打)|并且|(写)|和像那样|(打)|并且|(写)|带有|已连接|到|中午|女性的特质，|和|苏坤|应该|然后为它|箱子|一个人，|它是|那|高度重视|与它|中午|重点|黑体|或者|光，|就像|(光强调的命中)|并且|(光强调的写)|就像|(强强调的命中)|并且|(强强调的写)。|如果|was|它现在时态|已连接|它的结局的|然后它|使命令心情|与删除|这封信的|自身的缺陷，|然后命令|从它|生成|upon|删除|这封信的|自身的缺陷，|就像|(电话)|并且|(法官)|并且|(努力)。|如果|was|它现在时态|从|动词|五|然后它|使命令模式|与删除|中午，|然后命令|从它|生成|upon|删除|中午，|就像|(你们两个写)|并且|(你所有男性写)|并且|(你女性写)。
GreatMasterpiece39=Subjunctiveness|现在时态|它说:|然后 subjunctiveness|十年|和他们是:|到那，|和永远不会 / 不会|和那时/因此，|并且，为了到所以，|和林|因此|和林|逃税行为，|和直到/达，|和一个句子的响应，结论，扼要子句|与发|和 waw|和或。|我说:|组/颗粒|其中|划分|在它以后|动词|现在时态|十|颗粒|和他们是|打开|三|部件:|部分|使虚拟语气|与本身，|部分|使虚拟语气|与那|已销毁|在它以后|所允许的 (允许)|部分|使虚拟语气|与那|已销毁|在它以后|由必要性。|对于|第部分|第一个|-|它是|什么|让宾格|动词|现在时态|与本身|-|然后四|颗粒|和他们是:|到那，|和永远不会 / 不会|和那时/因此，|并且，为了向所以。|对于|(对...)|然后一个粒子|口头|和虚拟语气|和将来时态，|和它的例子|它说:|最高:|(我希望|那|将原谅|me)(26:82)|它说:|崇高|它提醒人们:|(而且我也不怕|那|他是吃|由 wolf)(12:13)|它说:|最高:|(真正|这让我很伤心|那|你应该带走|与 him)(12:13)|它说:|最高:|(和他们都同意|那|他们让把他|in|底部|well)(12:15)。|和|(永远不会 / 不会)|然后一个粒子|否定，|和虚拟语气，|和将来时态，|和它的例子|它说:|最高:|(不会 / 不会再|我们相信|在 you)(2:55)|它说:|最高:|(不会的|停止|在上面|worshiping)(20:91)|它说:|最高:|(绝不意味着会不|你实现|righteousness)(3:92)。|和|(那时/因此)|然后一个粒子|答复，|和奖励|和虚拟语气，|和所需|为虚拟语气|现在时态|与它|三|条件:|第一:|那| Yin|(那时/因此)|in|在胸部|这句话的|答复。|第二种:|那| Yin|现在时态|时间|在它以后|该值指示|upon|未来。|第三:|那|非|分离|它之间|和之间|现在时态|分离|其他比/除外|宣誓|或者|感叹词|或者|(不)|否定之否定|和示例|实现|条件|那|它说:|给你|一|您的兄弟:|(我就会努力工作|in|我的研究)|然后你说|对他说:|(那时/因此/因此|你就会成功)|和示例|分离的|与誓言|那|你说:|(然后|由阿拉|你一定会成功)，|和示例|分离的|与感叹词|那|你说:|(然后|阿默罕默德|你一定会成功)，|和示例|分离的|与 laa|否定之否定|那|你说:|(然后|非|将不成功不成功|你的努力)|或者|你说:|(然后|由阿拉|非|将去|你的工作|要浪费)。|和|因此，(为了)|粒子|口头|和虚拟语气，|和要求|in|虚拟语气|与它|那|前面被句点|林|解释|表达，|就像|它说:|最高:|(按顺序，|你可能不是 grieve)(57:23)，|或者|前面被句点|此|林|含义，|就像|它说:|最高:|(按顺序，|非|它变得|fortune)(59:7)|然后当|没有|在它前面|此|林|表达式|而不是|暗示|was|虚拟语气|与那|隐藏，|和是|因此，(为了)|本身|一个粒子|解释。|和|第部分|第二个|-|它是|其中|使虚拟语气|动词|现在时态|通过手段|(对...)|隐藏|可容许性|-|然后一个粒子|一个人，|它是|林|解释，|和十字架|与它|作者|与林|所以，在订购，|订购两个|in|证据|upon|解释，|和它的例子|它说:|最高:|(这可能原谅|给你|真主|什么|来之前|从|你的罪|和什么|来自 after)(48:2)|它说:|崇高|would|(所以，将惩罚|真主|hypocrites)(33:73)。|和|第部分|第三个|-|它是|其中|使虚拟案例|动词|现在时态|通过手段|(对...)|隐藏|有必要|-|五|粒子:|第一:|林|逃税行为，|它的控制器|那|它前面|带有|(不|是的)|或者|(不|没有)|然后示例|第一个|它说:|最高:|(不|will|真主|离开|信徒|后在|什么|你|它目前 state)(3:179)，/|它说:|光荣:|(但不是|will|真主|惩罚 them)(8:33)|和示例|第二个|它说:|崇高|它的提醒:|(永远不会|shall|真主|原谅|他们|也不得|他引导他们|到任何正确的 way)(4:137)。|与颗粒|第三个|直到 (达)|它是|已使用|为目的/目标|或者|解释，|和意义|目标|那|什么|在它之前|将完成它|获取/由那|什么|在它之后，|就像|说|真主|最高:|(直到|returns|给我们|Moses)(20:91)|和意义|解释|那|什么|在它以后|原因|用于获取|什么|在它之后，|就像|你说:|对于一些|您的兄弟:|(研究|按顺序对所以，|您传递)。|两种颗粒与|第三个|和第四次:|美国联邦航空局|推理，|和 waw|陪护，|与条件|那|位于|每个|从他们|in|响应|否定|或者|请求|对于|否定|然后就像|它说:|最高:|(不|命中注定|对他们来说|然后他们将 die)(35:36)，|和|请求|然后八|事情:|命令必须|和恳求，|和禁止，|与质疑，|和演示文稿示范|和煽动行为，|与祝/欲望，|和希望及期望，|对于|请求|然后它是|该命令|发出|从|他具有重要意义的人|对谁| Yin|没有它，|就像|说|老师|对学生:|(研究|然后你将会成功/通)|或者|(和你将会成功/通)|和|恳求|然后它是|请求|有向|从|渺小|到|最大/重大，|就像|(O 真主|指引我|所以我可以做|好)|或者|(和我可以做|好)|和|预防|然后就像:|(不做|播放|因为失去了你|你希望)|或者|(和你失去的|你的希望)，|和|质疑|然后就像:|(没有|你记住|你的功课|所以我可以听到它|从你)|或者|(和我可以听到它|从你)，|和|演示文稿或示范|然后它是|请求|由和蔼，友善温柔|就像:|(是|你看我们|所以我们可以荣誉/主机你)|或者|(和我们可以荣誉/主机你)|和|煽动|然后它是|请求|带有|动机|和干扰|就像:|(没有|你做|你的工作|所以，会感谢你|你的父亲)|或者|(和会感谢你|你的父亲)，|和|希望/渴望|然后它是|请求|不可能，|或者|什么|在它|是困难，|就像|这句话|诗人:|但愿|星星|被关闭或其附近|对我来说|所以能帮你安排一下|在项链/合同|赞美/美化|所以不|我很满意|和你一起|我的词语|和它的例子|说|结束:|那|但愿|青春|将返回|一天|所以我可以通知他|什么|没有|年老时|和一样:|但愿|我有|金钱|所以我可以执行麦加朝圣|与从它)，|和|希望及期望|然后它是|请求|命令的|附近的|发生|就像:|(也许|真主|会治愈我|所以我可以来拜访你)。|肯定|收集|某些|科学家们的|这些|事情|九|其中|之前|美国联邦航空局|和 waw|in|房子/线|一|它是:|命令，|和苦苦哀求，|和禁止，|问:|并展示礼物 /|对冲动/煽动/劝他们|愿望，|希望/期待，|诸如此类|否定，|当然|完成|和肯定|记得|作者|它|八、|为此他|没有|考虑|希望及期望|从他们。|粒子|第五个|(或者)|要求|in|此|这个词|那| Yin|与意义|(除外)|或者|与意义|(对)|与控制器/规则|第一:|那| Yin|什么|之后|it|完成|在一个实例中/一次|就像:|(我会真的杀了|不信道的人|除非|他成为穆斯林)|与控制器/规则|第二:|那| Yin|什么|在它以后|完成|步骤或物|由一步/然后事情，|就像|说|诗人:|事实上我曾|困难|容易|要实现/到达|愿望|所以不|指南|希望|除了|病人|练习/演习|1-|接听|从|每个|句子|从|句子|给出了|用两句|in|每个|一|从这两个|一个动词|现在时态。|(裁决)|此培训完成后，受众能够做些什么?|其中|延迟/删除/暂停你|从|你的兄弟吗?|() b|将|你去旅行|明天?|() c|如何|你会做|If|你想要|学习吗?|() d|其中|食品|你喜欢吗？|() e|where|生活|哈利勒?() f|输入|其中|公园/游乐场|你花了|1 天|假期吗?|() g|谁|是一个人|花|你吗?|() h|几个|小时|你花吗|in|学习|每隔|一天吗?|2-|付诸表决|in|每个|地方|从|地方|空闲|一个动词|现在时态|然后|参考|其类型|从|拐点|并且|标志|它的拐点:|(裁决)|我来|昨天|......|然后不|找到了你。|() b|它让我开心|那|......|() c|我爱|阿里|因为他|......|() d|不会|......|工作|今天的|到|明天。|() e|你们两个|......|哈立德。|() f|我去拜访你的两个|所以，在到订单|......|和我一起|到|公园/游乐场。|() g|给你|那些人|......|家庭作业。|() h|非|你将会|虔诚/真诚|直到|......|你的行为。|() i|他的人|想要|......|他自己|不应该|落在后面/被忽视|in|他的家庭作业。|() j|很抱歉|在我身上|那|......|() k|加速|走了的路|因此|......|第一个|工作。|() l|不会|......|罪人|从|处罚。|() m|坚持持续存在|upon|你的工作|因此|......|() n|执行|你的职责|所以，在到订单|......|upon|快乐|真主|() o|他们离开|这场比赛|......|() p|如果不是|那|......|在你身上|我本来要求/期望从你|要上瘾|上班。|问题|此培训完成后，受众能够做些什么?|的|工具|其中|使虚拟语气|现在时态|与本身吗?|此培训完成后，受众能够做些什么?|是的意义|(对...)|和什么|是的意义|(将不要)|和什么|是的意义|(那时/因此)|和什么|是的意义|(按顺序向所以的)?|此培训完成后，受众能够做些什么?|其中|要求|为虚拟语气|现在时态|之后|(那时/因此)|前后|因此，(为了) 吗?|此培训完成后，受众能够做些什么?|的|事情|其中|非|危害|分离|与它|介于|(那时/因此)|虚拟语气|和现在时态?|当|使虚拟语气|(对...)|隐藏|允许的吗?|当|使虚拟语气|(对...)|隐藏|有必要吗?|此培训完成后，受众能够做些什么?|是的控制器|之林|逃税吗?|此培训完成后，受众能够做些什么?|是的意义|(直到)|虚拟语气?|此培训完成后，受众能够做些什么?|的|事情|其中|必须|那|先于|一|从他们|fah|推理的|或者|waw|陪护吗?|做例子|为每个|什么|你学习它。
GreatMasterpiece40=命令|现在时态|它说:|和命令|八|十、|和他们是:|没有，|并不是什么，|也没有，|和什么不一样，|和林|命令|和恳求，|并且|(不做)|in|禁止|和恳求，|和，如果，|和什么，|和谁，|无论，|每当 / 如果|什么，|而，|时候，|在哪里|和下落，|和这样，|何地，|然而，|和那时/因此|in|诗歌|具体。|我说:|工具|其中|使命令的心情|动词|现在时态|八|十|命令，|和这些|工具|除|到|两个部分:|第部分|第一，|每个|一|在它|使命令心情|一个动词|一个人，|和部分|第二个|每个|一|从它|使命令心情|两个动词。|对于|第部分|第一，|然后六|颗粒，|和他们是:|没有，|和做的时候，不|也没有，|和什么不一样，|和林|命令|和恳求，|并且|(不做)|in|禁止|和恳求，|和他们每个人都|颗粒|与共识|语法。|对于|(没有)|然后粒子|否定之否定|和命令|和改变，|就像|它说:|最高:|(不|were|那些人|disbelieved)(98:1)|它说:|最高:|(说|没有|你 believe)(49:14)。|和|(没有不/时)|然后粒子|看起来像|(没有)|in|负|和命令|和改变，|就像|它说:|最高:|(当然|不还|味道|处罚)。|和|(没有)|然后它是|(没有)|已添加|在上面|哈姆扎|建立，|就像|它说:|最高:|(没有|我们打开|给你的|你的 chest)(96:1)。|和|(没有)|然后它是|(没有不/时)|已添加|在上面|哈姆扎|就像|(没有|我做得好|到你)。|和|林|然后当然|提到|作者|它|was|命令|和恳求，|和每个|从|该命令|祈求|注定|由它|请求|发生/发生|动词的|请求|命令，|与差异|两者之间|那|该命令| Yin|从|最高|到了最低水平|就像|in|圣训 》:|(然后说|好|或者|保持沉默)|和|恳求|然后它是|从|最低|到最高，|就像|它说:|最高|(使两端/杀|在我们身上|你的 Lord)(43:77)。|和|(不做)|然后当然|提到|作者|它|如下|为禁止|和恳求，|和每个|从这两个|是指|与它|请求|避免人弃权的|从|操作的动词|和离开它，|与差异|两者之间|那|禁止| Yin|从|最高|到了最低水平，|就像:|(不做|fear)(51:28)|和一样:|(不做|说|支付给我们听从/听 us)(2:104)|和一样:|(不做|夸大|in|你的 religion)(4:171)，|和|恳求|然后是|从|最低|到最高|就像:|(我们的主|非|对 us)(2:286) 的地方/躺着|它说:|崇高|将:|(而不是|地方|我们|burden)(2:286)。|和|第部分|第二:|它是|什么|它使命令的心情|两个动词，|和电话|这两个第一|动词|条件下，|和两个第二|响应|条件|和它的奖赏，|它是|upon|四|种类:|那种|第一:|一个粒子|根据协议，|和那种|第二:|一个名词|根据协议，|和那种|第三:|一个粒子|upon|更正确，|和那种|第四:|一个名词|upon|更正确。|对于|那种|第一:|然后它是|(如果)|只，|就像:|(如果|你研究修订|然后你会传递/成功)|然后如果:|粒子|条件|命令|由协议|语法，|它使命令的心情|两个动词，|第一|谓词|条件|和第二个|其响应|和它的奖赏，|并且|(研究/修改)|一个动词|现在时态|动词|条件|命令的心情|如果|和标志|其命令的|苏坤|和其积极的元素|代词|隐藏|在它|现有|其隐含|你，|并且|你将通过 (成功)|一个动词|现在时态|响应|条件|和它的奖赏，|命令的心情|如果|和标志|其命令的|苏坤|和其积极的元素|代词|隐藏|在它|现有|其隐含|你。|那种|第二个|它是|协定 》|upon|它|是一个名词|-|然后 9|名词，|和他们是:|谁，|和什么，|而，|时候，|和下落，|在哪里，|和这样，|何地，|但是。|然后示例|(谁)|你说:|(他的人|荣誉|他的邻居|会受到表扬)，|或者|(他的人|修改|将通过/成功)|它说:|最高|(然后谁|没有|重量|一个原子|好的|将会看到 it)(99:7)。|然后示例|(什么)|你说:|(什么/那的|你产生了|你将会|与它)|并且|(什么/那的|你读|你将受益|从它)|并且|(这其中|你做|在|好|将完全偿还|到你)。|和一个例子|(其中)|你说:|(任何|书|你读|你将受益|从它)|并且|(其中|什么|你叫|然后为他|名称|best)(17:110)。|和一个例子|(时)|你说:|(当|你观察/采取谨慎|到的|你的职责|您将被授予|快乐|你们的主)|和这句话|诗人:|我是|儿子|著名/著名|高之一|愿望|当|我穿上|我的头巾: 头部覆盖物|你知道/认识我，|和一个例子|(时)|你说:|(当|你会满足我|我将以你为荣)，|和这句话|诗人:|所以当|什么|你转身离去|从它|的气味|减少/减少|和一个例子|(无论)|你说:|(无论|你的头去|你满足|一位朋友)|它说:|最高:|(无论|他指示他|非|他会带来呢|任何 good)(16:76)|并且|(无论|你是|将取代你|death)(4:78)|和一个例子|(无论)|这句话|诗人:|无论在哪里|你站在直立适当纠正|将法令|给你的|真主|成功|in|过去/老/一切|次|和一个例子|(然而)|你说:|(然而|将|国家/伊斯兰世界|会有|领导/统治者)|并且|(然而| Yin|你的意图|would|奖励|真主|为你)|和添加|upon|这些|名词|九|当 (如果)|in|诗歌|像什么|说|作者，|和那|必要性|就像|这句话|诗人:|满意|什么|是给你的|你的主|财富|和什么时候|你被所困扰|贫困|然后要有耐心|和|那种|第三个|-|它是|什么|不同/争执|in|它|是一个名词|或者|一个粒子，|更正确|它是|一个粒子|-|然后，|一个粒子|一|它是|(无论何时)|和一个例子|这句话|诗人:|实在|每当|你做|这其中|您|命令|由它 (好好)|你会发现|他的人|给他|被吩咐|将做它|和|那种|第四个|-|它是|什么|不同/争执|in|它|是一个名词|或者|一个粒子，|更正确|它是|一个名词|-|然后，|是一个词|一个人，|它是|(无论)|和它的例子|它说:|最高:|(和他们 (Moses 国家) 说:|无论|你可能会带给我们|与它|从|标志|为了迷惑我们|与它|然后不|我们|在你|我们要去 believe)(7:132)，|和这句话|诗人:|和实在|无论|你给|你的胃|是什么它的愿望/要求|和你的私处|获取|结束/最大|中伤/诽谤|收集|演习/练习|1-|指定引用到|动词|存在|时态/时间|in|句子|给出，|然后|请参阅|陈述语气|从他们|和虚拟语气|和命令的心情，|和是指|标志|它的拐点:|他的人|植物|好|竖琴/收获|好|......|不要|变慢|in|你的责任/义务|......|你要当心|那|饮用|虽然你|是用尽了累了|......|很多/过度|笑的|使枯萎死 /|心|......|他的人|轮流远离|真主|转过身去|真主|从他|......|If|你坚持下去|后在|工作|然后你会赢|......|他的人|没有|知道|权利|人|在他结束|没有|知道|人民|他的权利|在他们以上|......|无论|你努力|你会发现|寄托|......|无论|去|之前科学家的学者|尊重他|人民|......|非|它是适用于|为私钥的持有人|男子气概和慷慨的|那|以是开玩笑的|好多|......|然而|你将会|将领导/老板/头会怎么样|在你身上|......|If|你保存/商店/就丢在一边|这笔钱|你将受益|......|If|你是|疏忽|变得更糟|你的条件|......|无论|你隐藏/隐藏|将暴露出来它|天|......|不要|被|爱讲闲话/唠叨的人|所以你不会不开心/悲惨。|2-|Enter|每个|谓词|从|动词|现在时态|给出了|in|三|句子，|与条件|那| Yin|陈述语气|in|一|从他们，|和虚拟语气|在第二个，|和命令的心情|在第三。|你她培养，|你她旅行，|你她玩，|你她出现，|你所有的爱，|你女性的饮料，|你们两个/两个女人去，|你她希望，|他说话的口气不理性/神志不清，|你她接受。|3-|付诸表决|in|每个|地方|从|地方|空闲|从|例子|给出了|一个粒子|条件|适合/适当:|(裁决)|......|你将参加|将出席|你的父亲。|() b|......|你会善待别人|我会和他交朋友。|() c|......|你玩|你会后悔。|() d|......|你隐藏|将显示给他|你的作品。|() e|......|你走|我去|与你。|() f|......|你学习|在它|它将使你受益。|4-|已完成|句子|给出了|地位|动词的|现在时态|适当情况下，|和调整|它的结局:|(裁决)|If|你犯下的罪|......|() b|If|瀑布|玻璃|......|() c|无论|你做|......|() d|任何|人员|你成为我们的朋友|......|() e|If|你把|盐|in|水|......|() f|无论|你走|......|() g|然而|将|一个人|......|() h|谁|访问我|......|() i|每当| Yin|这位学者|......|() j|无论|去|这位学者|......|5-|已完成|从|每个|两个句子|按比例|从|句子|给出了|一个句子|其原理|带有|粒子|条件|为他们相称:|你注意|到|这一课|如果你坚持|电线|电力，|你将到达|很快，|你将受益|从它，|你开车|一辆车，|你会震撼，|你关闭|windows|你的房间，|你做|你的职责，|瀑布|雨中，|会变得陈旧|空气中，|他会赢|安居乐业|人，|开启|把伞。|问题|进入|几个|部件|划分|粒子的命令的心情吗?|此培训完成后，受众能够做些什么?|的|粒子的命令的心情|其中|使命令的心情|一个动词|其中一个吗?|此培训完成后，受众能够做些什么?|的|颗粒|命令的心情|其中|使命令的心情|两个动词?|请参阅|对名词|同意|upon|其名义/名词形式|和颗粒|同意|upon|其颗粒状|从|粒子的命令的心情|其中|使命令的心情|两个动词，|让|为每个|命令的粒子|使命令的心情|一个动词|一|用两个例子，|并给出|为每个|命令的粒子|使命令的心情|两个动词|带有|示例|一|显示/显示|在它|动词|条件|和应对的答案。
GreatMasterpiece41=数字|主格的案件|和他们的例子|它说:|(章|主格例的|名词)|主格例|7、|和他们是:|活跃的元素，|和对象|其中|非|一直叫|它的主题，|问题，|和谓语，|和的名词|(是) / 动词是|和它的姐妹，|和的谓词|(当然) / 宾格粒子|和它的姐妹，|和追随者|主格的|它是|四|事情:|形容词，|和一起，|并强调，|和替代。|我说:|当然|你知道的|用什么|是一种过去|那|名词|屈折变化|位于|in|三|地点:|位置|主格的|和位置|宾格的|和位置|所有格，|和每个|一|从|这些|位置|要素的原因|是必需的|和肯定|开始|作者|解释|给你|那|后在|详细信息，|和开始|与提|主格的个案中，|因为，他们|是最杰出的|和肯定|提到|那|名词| Yin|主格|in|七|类型。|1-|当|was|活跃的元素，|和它的例子|(阿里)|并且|(穆罕默德)|in|就像|你说:|(出席|阿里)|并且|(旅行|默罕默德)。|2-|它| Yin|替代/代表|从|活跃的元素，|它是|这其中|被称为|作者|对象|其中|没有|名称/电话|它的主题，|就像|(分支)|并且|(商品)|从|你说:|(被切断|分公司)|并且|(被偷了|商品)。|3，|4-|主题|和谓语，|就像:|(默罕默德|是一个旅行者)|并且|(阿里|是一个勤劳的工人)。|5-|名词|(是) / 动词是|或者|一|它的姐妹|就像:|(亚伯拉罕)|并且|(冷)|从|你说:|(是|亚伯拉罕 ·|一个勤劳的工人)|并且|(成为了|寒冷|严重)。|6-|谓词的|(如果)|或者|一|它的姐妹，|就像:|(优秀)|并且|(强大)|从|你说:|(实在|默罕默德|是优秀)|并且|(肯定/的确|真主|是经一遍|全部|事情|功能强大)。|7-|从动件|主格的|和追随者|四|种类:|第一|形容词，|和那|就像:|(尊敬)|并且|(光荣/慷慨)|从|你说:|(拜访了我|默罕默德|尊敬)|并且|(遇见我|一个男人|光荣/慷慨)，|和第二个|连词，|它是|upon|两个部分:|连词|实地调查，|和连词|协调，|然后示例|结合|实地调查|(欧麦尔)|从|你说:|(旅行|父亲|哈夫斯|欧麦尔)|和示例|结合|协调|() Khalid|从|你说:|(参加|默罕默德|和哈立德)|第三个|强调，|和它的例子:|(自己)|从|你说:|(拜访了我|领导者的王子/指挥官|他自己)|第四|取而代之，|和它的例子|(你的兄弟)|从|你说:|(是目前/出席|阿里|你的弟弟)。|如果|你放在一起|这些|关注我的人|他们每个人都|或者|其中一些|in|语音|第一把|形容词，|然后|连词|实地调查，|然后|强调，|然后|取而代之，|然后|连词|协调，|你说:|(来了|男子|尊贵大方|阿里|他自己|你的朋友|和他的弟弟)。|练习|在关于|拐点|活用|例子|给出:|(亚伯拉罕|是忠实/真诚，|和是|你的主|都是强大的|真正|真主|是听话人|所有恳求)。|答复|1-|(亚伯拉罕)|是一门学科，|主格|按主题、|和标志|它主格的|damma|很明显，|(忠实/真诚)|谓词|为主题，|主格|按主题、|和标志|它主格的|damma|明显。|2-|(是)|一个动词|过去时态|不规则，|使得主格|名词|和使宾格|谓词，|(主)|名词|动词，是的|主格|通过它，|和标志|它主格的|damma|很明显，|和主|附加所拥有，|和 kaf|代词|处理/二人|连接藏有|到它，|结构|upon|罚的骂|in|地方|所有格，|(都是强大的)|谓词|动词，是的|宾格|通过它，|和标志|其宾格的|罚的骂|明显。|3-|(真诚)|一个粒子|重点|和宾格|(真主)|名词|真正宾/粒子|宾格|通过它，|和标志|其宾格的|罚的骂|很明显，|(听话人)|谓词|宾格助词的|主格|通过它，|和标志|它主格的|damma|很明显，|和听话者|附加所拥有，|并且|(指所有的恳求)|连接藏有|到它，|所有格|由附件/藏建设|和标志|其所有格的|kasra|明显。|问题|输入|几个|种类|was|名词|主格?|此培训完成后，受众能够做些什么?|种类|追随者吗?|如果|组合|重点|和连词|实地调查|形容词和|那么如何|是他们安排吗?|如果|组合|追随者|所有这些|那是什么|其中|是第一位|从他们吗?|给|为主题|和谓语|用两个例子，|闭合|为每个|从|名词|动词对 be/(was)|和谓词|宾格 particle/(truly) 的|和活动元素|及其替代品|两个例子。
GreatMasterpiece42=它说:|(章|活性元素)|活动元素|它是:|名词，|主格，|一提|在它之前|其动词。|我说:|活动元素|为它|两层含义:|这两个第一|词汇/语言/文字|和第二个|术语/技术/理论。|对于|它的意思|in|词汇|然后它是|一个短语的单词/表达式|关于一个|把关于造成|一种操作。|和|它的意思|in|术语|然后是:|名词|主格|提到|在它之前|它的行动，|像什么|说过|作者。|和我们说|(名词)|非|包含|动词|而不是|粒子，|然后不|was|一|从这两个|活跃的元素，|和它|包含|名词|清楚|和名词|解释|与清除:|对于|清除|然后就像:|(诺亚)|并且|(亚伯拉罕)|in|它说:|最高:|(说|Noah)(71:21)，|(和时|引发|Abraham)(2:127)，|和|解释|与清除|就像|它说:|最高:|(这并不|对他们来说足够|那我们|revealed)(29:51)，|然后:|一个粒子|重点|和宾格|并且|(我们)|其名词|结构|upon|苏坤|in|地方|宾格的|并且|(我们透露)|一个动词|过去时态|和其积极的元素，|和这句话|in|地方|主格的|谓词|，宾粒子|并且|(，)|和什么|输入|在上面|in|解释|分词/不定式|活动元素|(它是足够)|并暗示:|这并不|对他们来说足够|我们揭示，|和它的例子|你说:|(这让我高兴|那|你抓住/继续对|美德和道德卓越)|和你说:|(它惊讶/使我吃惊的|什么|你制作)，|含义|在他们，|它让我开心|你抓住/坚持，|和它惊讶/使我吃惊的|你的生产。|和我们说:|(主格)|拿出/提取物|这其中|was|宾格|或者|所有格，|然后不| Yin|一|从他们|活跃的元素。|我们说:|(提到|在它之前|其动词)|拿出/提取物|主题|和的名词|(宾格粒子/真实地)|和它的姐妹，|为确|非|他们前面的是由|动词|确定性，|它又出/提取物|还|名词|(是动词要)|和它的姐妹，|和的名词|(将附近/点)|和它的姐妹;|然后当然这两个|如果|前面两个|一个动词|然后如果|此|谓词|不是|一个动词|一|从他们两人，|和本来是准备|由动词|那是的|包含|什么东西像|动词|像这个名词|口头|in|就像:|(多远|是峡谷的峡谷/山谷)|并且|(多么不同|是扎伊|和 Amr)|和分词|可用|in|它就像|(来|你的父亲)|然后峡谷/峡谷/山谷，|和 Zayd|带有|什么|附加倾向于|在其上，|和你的父亲:|每个|从它|活跃的元素。
GreatMasterpiece43=部分|活动元素的|和类|明显|从它|它说:|它是|upon|两个部分:|很明显，|和隐藏，|然后明显|就像|你说:|站在|宰，|和站|宰，|和站在那里|两个 Zayds，|和站|两个 Zayds，|和站在那里|Zayds，|和站|Zayds，|和站在那里|男人，|和站|男人，|和站在那里|后腿，|和站|后腿，|和站在那里|两个海因兹，|和站|两个海因兹，|和站在那里|不要惊动，|和站|海因兹|和站|不要惊动，|和站在那里|你的父亲，|和站在那里|小男孩奴隶|和站|小男孩奴隶|和什么|是类似于|那。|我说:|划分|活动元素|into|两个部分:|第一|表观|和第二个|隐藏，|然后为|表观|然后是:|这其中|是指|upon|它的意思|和其他无|需要|到|上下文连接，|和|隐藏|然后是:|这其中|没有|参考|upon|目的|从它|除了|与上下文，连接关联|对一位发言者 / 1 人|或者|其中之一是处理/2 人|或者|一个人是缺席/3 人。|和明显|upon|类型:|因其|作为为|那| Yin|单数|或者|双|或者|表格|复数|声音|或者|复数|破碎的|和每个|从|这些|类型|四|作为为|那| Yin|男性|作为为|那| Yin|女性;|然后这些|八|类型，|和也|然后为|那| Yin|其拐点|与 damma|表观|或者|应该，|和|那| Yin|其拐点|用字母|替代|从|damma，|和后|每个|这些|条件|作为为|那| Yin|动词|过去时态，|和|那| Yin|现在时态。|然后示例|活动元素的|单数|男性:|带有|动词|过去时态|(出席|这两个朋友，|和参加|哈立德)|和与|动词|现在时态|(游记|默罕默德，|并出席|哈立德)。|然后示例|活动元素的|双|男性:|带有|动词|过去时态|(出席|这两个朋友，|和移动|两兄弟)|和与|动词|现在时态|(出席|这两个朋友，|和旅行|两兄弟)。|和示例|活动元素|表格|复数形式|健全性|对于男子气概|带有|动词|过去时态|(出席|穆罕默德，|和执行的朝圣|穆斯林)|和与|动词|现在时态|(出席|穆罕默德，|和执行朝圣之旅|穆斯林)。|和示例|活动元素的|表格|复数形式|破碎的|-|它是|男性|-|和与|动词|过去时态|(出席|朋友们，|和移动|领导人)|和与|动词|现在时态|(出席|朋友们，|和旅行|领导人)。|和示例|活动元素的|单数|女性:|带有|动词|过去时态|(出席|后腿，|旅行|萨阿德)|和与|动词|现在时态|(出席|后腿，|和旅行|萨阿德)。|和示例|活动元素的|双|女性:|带有|过去时态|(出席|两个海因兹，|和移动|两个 Zaynabs)|和与|现在时态|(出席|两个海因兹，|和旅行|两个 Zaynabs)。|和示例|活动元素的|表格|复数形式|健全性|女性:|带有|过去时态|(出席|不要惊动，|和移动|) Zaynabs|和与|现在时态|(出席|不要惊动，|和旅行|Zaynabs)。|和示例|活动元素的|表格|复数形式|破碎的|它是|女性:|带有|过去时态|(出席|不要惊动，|和移动|) Zaynabs|和与|现在时态|(出席|不要惊动，|和旅行|Zaynabs)。|和示例|活动元素的|其中|其拐点|是 damma|表观|一起|从那的|来之前|in|例子|其中|除了|双|男性|和女性|和复数|酣然|为男性。|和示例|活动元素的|其中|其拐点|与 damma|应该，|带有|动词|过去时态|(出席|那个男孩)|并且|(旅行|法官)|并且|(接受|我的朋友)|和与|动词|现在时态|(出席|那个男孩)|并且|(游记|法官)|并且|(接受|我的朋友)。|和示例|活动元素的|其中|其拐点|与这封信|而代以|从|damma|什么|来之前|从|示例|动词的|双|男子气概|或者|女性的特质，|和示例|动词的|表格|复数|酣然|对于男子气概，|和从|他们的例子|此外，|带有|过去时态|(出席|你的父亲，|和移动|你的哥哥)|和与|现在时态|(出席|你的父亲，|和旅行|你的弟弟)。
GreatMasterpiece44=种类|活动元素的|隐藏|它说:|隐藏|是两个|十、|就像|你说:|(我打，|和我们打，|和你阳刚打，|和你女性的命中，|和你两个打，|和你所有男性打，|和你所有女性打，|和他打了，|和她打，|和他们两个打，|和他们阳刚打，|和他们女性打)。|我说:|当然|你知道的|在什么|来之前|隐藏|什么|它是，|现在|这是众所周知的你|它|upon|二|十|种类:|和那|因为它|作为为|那|是指|upon|一位发言者，|至于|那|是指|upon|每秒处理的人，|至于|那|是指|upon|另一/三人，|而|是指|upon|一位发言者/第一人称，|各不相同|到|两种:|因为它|作为为|那| Yin|演讲者/第一人|一个人，|至于|那| Yin|更多|于|一个人，|而|参考|upon|每秒处理人|或者|其他/三人|变化|每个|其中|到|五|类，|因为它|作为为|那|是指|upon|单数|男性，|至于|那|是指|upon|单数|女性，|至于|那|是指|upon|双|不受限制，|至于|那|是指|upon|复数|男性，|至于|那|是指|upon|复数|女性|然后是|表格|二|十。|然后示例|代词的|演讲者/第一人|一个人，|男性|was|或者|女性|(一打)|并且|(背下)|并且|(我是工作硬/勤奋)。|和示例|代词的|演讲者/第一人|超过一个/多个|或者|一|谁|尊荣|他自己|和它放在|位置|组的|(我们袭击了)|并且|(我们记忆)|并且|(我们都努力工作，勤奋)。|和示例|代词的|处理/二人|一|男性|(你男性袭击了)|并且|(你男性记忆)|并且|(你都工作硬/勤奋)。|和示例|代词的|处理/二人|一|女性|(你袭击了女性)|并且|(你女性记忆)|并且|(你都工作硬/勤奋)。|和示例|代词的|处理/二人|二|男性|或者|女性|(你袭击了两个)|并且|(你们两个能记住)|并且|(你都努力工作，勤奋)。|和示例|代词的|处理/二人|从|复数|男性|(你所有男性袭击了)|并且|(你所有男性记忆)|并且|(你所有男性都工作硬/勤奋)。|和示例|代词的|处理/二人|从|复数|女性|(你所有女性击中了)|并且|(你所有女性记忆)|并且|(你所有女性都工作硬/勤奋)。|和示例|代词的|之一|男性|其他/三人|(他击中，击中，节拍)|in|你说:|(默罕默德|打，打，打|他的弟弟)|并且|(他能记住)|in|你说:|(亚伯拉罕|记忆|他的课)|并且|(他是工作硬/勤奋)|in|你说:|(哈立德|工作辛苦/勤奋|in|他的工作)。|和示例|代词的|一|女性|三人|(她用力地打)|in|你说:|(后腿|袭击了|她的妹妹)|并且|(她能记住)|in|你说:|(萨阿德|记忆|她的课)|并且|(她是工作硬/勤奋)|in|你说:|(赞|工作辛苦/勤奋|in|她的工作)。|和示例|代词的|二|其他/三人|男性|was|或者|女性|(他们袭击了两个)|in|你说:|(两个穆罕默德|袭击了|巴克尔)|或者|你说:|(两个不要惊动|袭击了|阿米尔)|并且|(他们两个记忆)|in|你说:|(两个穆罕默德|记忆|他们两个的教训)|或者|你说:|(两个不要惊动|记忆|他们两个的教训)|并且|(他们两个正在努力勤奋)|从|就像|你说:|(两个 Bakrs|是努力工作，勤奋)|或者|你说:|(两个 Zaynabs|是努力工作，勤奋)|并且|(他们两个站)|in|就像|你说:|(两个穆罕默德|没有|他们两个的职责)|或者|你说:|(两个不要惊动|没有|他们两个的职责)。|和示例|代词的|其他两个/第三人|从|复数|男性|(他们阳刚节拍/打)|从|就像|它说:|(男人|拍击击中|他们的敌人)|并且|(他们阳刚记忆)|从|就像|它说:|(学生|记忆|他们的课程)|并且|(他们男性工作努力勤奋)|从|就像|你说:|(学生|是的工作硬/勤奋)。|和示例|代词的|其他/三人|从|复数|女性|(他们女性节拍/打)|从|就像|你说:|(女孩|拍击击中|他们的敌人)|和像那样|(他们女性记忆)|从|就像|你说:|(妇女|保障|他们的信任)|和像那样|(他们女性工作努力勤奋)|从|就像|你说:|(女儿/女孩|是的工作硬/勤奋)。|和每个|这些|种类|二|十|上一页|调用|代词|在他们|(代词|附后)|和众所周知的|它|等于:|其中|没有|启动|与它|这个词|而不是|显示来|之后|(除外)|in|条件/箱|选择/常用的演讲。|和它的例子|给出了|in|种类|结局|从|代词|被称为|(代词|分隔所分离)|和它是:|其中|开始时间|与它|又出现 /|之后|(除外)|in|条件/箱|选择/常用演讲的|你说|(不|他击中了|除了|我)|并且|(不|他击中了|除了|我们)|并且|(不|他击中了|除了|你阳刚)|并且|(不|他击中了|除了|你女性)|并且|(不|他击中了|除了|你们两个)|并且|(不|他击中了|除了|你所有的男性)|并且|(不|他击中了|除了|你所有女性)|并且|(不|他击中了|除了|他)|并且|(不|他击中了|除了|她)|并且|(不|他击中了|除了|两个)|并且|(不|他击中了|除了|他们男性)|并且|(不|他击中了|除了|他们女性)。|后|此|如下|比喻。|和会|有人指出|种类|代词的|分离/拆|更多/更详细|从|这些|标志|in|这一章|主题|和谓词。|演习/练习|1-|生成|每个|名词|从|名词|给出了|活动元素|in|两句话，|与条件|那| Yin|动词|过去时态|in|一个两个，|和一般现在时|in|其他:|你的哥哥。|你的朋友。|商人。|真诚的人。|我的儿子。|老师。|这棵树。|春天。|好。|2-|给|带有|每隔|谓词|从|动词|给出了|两个名词，|和使|每个|一|从他们|活动元素|为它|一个句子|适用于:|他参加了。|他买了。|他获得了赢利/韩元。|他救了。|他成功了。|他没有/形式。|她的果子。|他的方法/临近。|他哀叫一声/嘶叫。|3-|接听|从|每个|问题|从|问题|给出了|同一个句子|有意义|非独占|upon|一个动词|和积极的元素:|(裁决)|当|你旅行吗?|() b|位置|正在|你的雇主?|() c|没有|参加|你的哥哥吗?|() d|如何|你找到了吗|这本书吗?|() e|什么|你做了吗?|() f|当|我将见到你吗?|() g|位置|你将花费|本赛季|夏天吗?|() h|什么|其中|你正在学习它?|4-|生成|从|这个词|给出了|一个句子|包括|每个|一|从他们|upon|一个动词|和积极的元素:|他成功了。|他赢了。|他溢出。|他变得柔和了。|勤劳的工作者。|真诚。|花。|尼罗河。|商人。|运动|upon|拐点|活用|句子|给出:|出席|默罕默德。|旅行|所选择。|会来看我们|法官。|我接受|我的弟弟。|答案/响应|1-|已参加|默罕默德|-|出席:|一个动词|过去时态|结构|upon|罚的骂|非|一个地方|为它|从|屈折变化，|默罕默德:|活动元素|主格|和标志|它主格的|damma|表观|in|它的结束。|2-|旅行|所选|-|旅行:|一个动词|过去时态|结构|upon|罚的骂|非|一个地方|为它|从|屈折变化，|选择:|活动元素|主格，|和标志|它主格的|是 damma|应该|upon|阿勒夫|防止|从|其明显|不可能的事。|3-|我们还将赴|法官|-|我们将旅行:|所见|一个粒子|该值指示|upon|未来，|他旅行，|一个动词|现在时态|陈述语气|为其免费|从|虚拟语气|与命令，|和标志|它指示性的|damma|很明显，|和我们:|代词|采取行动|在上面|结构|upon|苏坤|in|地方|宾格的|法院和法官:|活动元素|主格，|和标志|它主格的|damma|应该|upon|是啊|防止|从|其明显|困难。|4-|接受|我的兄弟|-|接受:|一个动词|过去时态|结构|upon|罚的骂|非|一个地方|为它|从|屈折变化，|和哥哥:|活动元素|主格，|和标志|它主格的|damma|应该|upon|它的结局|防止|从|其明显|函数|一个地方|与元音|适当情况下，|和兄弟|拥有所附，|和严|第一人|代词|连接藏有|到它|结构|upon|苏坤|in|地方|所有格。|问题|此培训完成后，受众能够做些什么?| Yin|活动元素|语言|和术语吗?|给|为活跃的元素|显式;explicit|两个例子|和积极的元素|解释|与显式|两个例子|此外，|让|为活跃的元素|主格|与名词|动词的|用两个例子，|和积极的元素|主格|与名词|动词的|用两个例子，|到|几个|部件|划分|积极的元素吗?|此培训完成后，受众能够做些什么?| Yin|明显的吗?|此培训完成后，受众能够做些什么?| Yin|隐藏?|自|几个|部件|划分|隐藏?|后|几个|种类|各不相同|代词|连接吗?|此培训完成后，受众能够做些什么?| Yin|代词|分隔的所分离的吗?|给|为代词|分离/拆|效果|活动元素|带有|二|十|示例|品种，|和显示|什么|是指|在上面|in|每个|从它。|活用|这句话|给出:|写过|马哈茂德|他的课|......|购买|阿里|一本书|......|(我的百姓啊|响应|向调用方/召唤师|Allah)(46:31)|。|(无论是谁|行为|理直气壮地|然后为他的灵魂|)(41:46)。
GreatMasterpiece45=替代|从|活动元素|它说:|(章|外力|其中|没有|呼叫|其积极的元素)|和它是:|名词，|主格，|其中|没有|提及|与它|其积极的元素。|我说:|当然| Yin|这次演讲|作者|从|一个动词|和积极的元素|并采取行动时|有了它，|就像|(切|马哈茂德|分公司)|就像|(记住|哈利勒|这一课)|就像|(削减|亚伯拉罕 ·|分公司)|并且|(记忆|阿里|这一课)|和肯定|删除|演讲者/第一人|活动元素的|从|此|语音|和满意|与提|动词的|和其行事，|在这种情况下或在这段时间|它是必要|在上面|那|CHANGES|窗体|动词，|和变化|形式|行动上|此外，|对于|CHANGES|图像|动词的|然后将给|这次演讲|在其上，|和|CHANGES|形式|行动上|然后当然它|之后|那|was|宾格|变得|主格，|并给出了它|这项裁决|活性元素:|从|必要性|延迟|从|动词，|和女性气质|动词的|为它|If|was|女性，|和其他比|那，|和电话|在这种情况下|(替代|活性元素)|或者|(的所作所为后|其中|没有|呼叫|其积极的元素)。
GreatMasterpiece46=发生的变化|动词|之后|删除|活动元素的|它说:|然后如果|was|动词|过去时态|把 damma|第一|把 kasra|什么|之前|其结局/倒数第二|如果|was|现在时态|把 damma|第一|把罚的骂|什么|之前|其结局/倒数第二。|我说:|提到|作者|in|这些|标志|变化|其中|发生|in|动词|带有|删除|其积极的元素的|和它的附件|到|采取行动，|和那|它|If|was|动词|过去时态|提出了 damma|它的第一|并提出了 kasra|这封信|其中|早于|它的结局，|然后你说:|(被切断|分公司)|并且|(正在背|这一课)|如果|was|动词|现在时态|提出了 damma|它的第一|并提出了罚的骂|这封信|这就是|之前|它的结局，|然后你说:|(是被削减|分公司)|并且|(是被记住|课)。
GreatMasterpiece47=部件|而代以|积极的元素的|它说:|它是|upon|两个部门:|很明显，|和隐藏;|然后明显|就像|你说:|(被殴打/点击|扎伊德)|并且|(是殴打/点击|扎伊德)|并且|(荣获|) Amr|并且|(是荣幸|Amr)。|隐藏|二|十、|就像|你说:|(我是殴打/命中，|和我们被殴打/命中，|和你男性被殴打/命中，|和你女性被殴打/命中，|你们俩殴打/命中，|和你所有男性被殴打/命中，|和你所有女性被殴打/命中，|和他被殴打/命中，|和她被殴打/命中，|两人殴打/命中，|和他们男性被殴打/命中，|和他们女性被殴打/命中)。|我说:|划分|替代|活动元素的|-|像什么|划分|活动元素|-|到|表观|和隐藏，|隐藏|到|连接的|和超然。|和类|每个|部件|从|代词|二|十:|二|扬声器/第一人称，|和五|为解决/二人|和五|对于其他/第三次的人，|和肯定|我们提到过|详细|那|所有的它|in|这一章|活动元素的|然后不|需要|和我们一起|到|重复一遍||演习/练习|upon|拐点|活用|两个句子|给出:|被尊重|这位学者，|被羞辱被轻视|无知的人。|答案/响应|1-|尊重:|一个动词|现在时态|结构|用于被动语态，|陈述语气|为其免费|从|虚拟语气|与命令，|和标志|它指示性的|damma|很明显，|学者:|替代|活动元素的|主格|和标志|它主格的|damma|明显。|2-|被羞辱看不起:|一个动词|过去时态|结构|用于被动语态，|结构|upon|罚的骂|非|一个地方|为它|从|屈折变化，|无知的人:|替代|对于活跃的元素，|主格|和标志|它主格的|damma|明显。|练习/演习|1-|每个|句子|从|句子|给出了|作者|从|一个动词|和积极的元素|并采取行动，|然后删除|活动元素|和使|所作所为后|替代|从它，|和放|动词|与元音迹象|完成。|剪切|马哈茂德|一朵花，|购买|我的兄弟|一本书，|读取|亚伯拉罕 ·|他的课，|给 (慈善)|我的父亲|给穷人，|荣誉|老师|工作努力，|学习|我的儿子|扔，|寻求|悔改的人|我们的主。|2-|生成|每个|名词|从|名词|给出了|替代|从|活动元素|in|一个句子|有意义:|医生，|老虎，|这条河，|大鼠，|这匹马，|这本书，|这支钢笔。|3-|生成|每个|谓词|从|动词|给出了|用于被动语态，|把它放|与元音的迹象，|把 damma|到它|替代品|活动元素的|已完成|它的|与它|讲话。|他的荣誉|他削减|他的十字架，|他吃了，|他骑|他读，|他削尖 (铅笔)。|4-|指定|活动元素|其替代品|和动词|结构|为主动语态|和结构|用于被动语态，|从|引用|单词|其中|in|短语|给出:|有没有|失败 / 步子|从|一种求善，|和没有|遗憾|从|一个寻求咨询，|当|变强|你的兄弟|然后变得软弱，|他的人|不是|谨慎谨慎|造成的后果|非|他会发现|对他来说|一位朋友，|was|贾法尔|儿子|Yahyaa|说:|税收|是的支柱|王国统治的|和什么|一直高举/尊敬|这样的例子和|正义，|而不是|微不足道|这样的例子和|不公正的。|讲话|人民|仆人|最仁慈|儿子|接替的|那|辐射|欧麦尔|儿子|哈塔卜|in|那|使平静/软/温柔|对他们来说，|的确如此他|当然|有些害怕|甚至，|他担心|处女|in|他们的处所，|然后说:|欧麦尔:|真正我|不要|查找|对他们来说|除了|那，|当然他们|If|知道|他们有什么|与我，|他们会采取抓起 /|我的服装|依据|我的脖子/喉咙，|非|指责|是谁|照顾/看起来后|自己，|谁|被保护|从吝啬/贪婪|自己的|将是安全的。|问题|此培训完成后，受众能够做些什么?| Yin|替代|活性元素吗?|如何可以|你明白|为它|一个名词|由它的结局吗?|此培训完成后，受众能够做些什么?|其中|它的行为|in|动词|附近的|其附件|替代|一个积极的元素吗?|此培训完成后，受众能够做些什么?|其中|没有它|in|所作所为后|If|保持它|这个地方|活性元素吗?|生成|三|示例|改为|活动元素的|明显。
GreatMasterpiece48=主题|和谓词|它说:|(章|主题|和谓词)|主题:|它是|名词|主格|空闲|从|原因/因素/主动元素|口头表达 /|和谓词:|它是|名词|主格|依赖项|到它，|就像|你说:|(宰|是站)|并且|(两个 Zayds|站)|并且|(Zayds|站)。|我说:|主题|标志|从那|查找|在它|三|东西，|第一:|那| Yin|名词，|然后免费|从|那|动词|和粒子，|和第二次:|那| Yin|主格，|然后免费|与那|宾格|和所有格|用粒子/介词|所有格的|源语言|和第三:|那| Yin|空闲|从|因素/原因/主动元素|口头表达 /|和意义|这|那| Yin|空闲|从|因素/原因/主动元素|表达式/口述|制作|动词|和一个例子|be/(was) 对动词|和它的姐妹;|然后如果|名词|事件|之后|一个动词| Yin|活动元素|或者|替代|从|活动元素|upon|什么|以前|解释说，|名词|发生|之后|be/(was) 对动词|或者|之一|它的姐妹|被称为|(名词|是动词)|而不是|被称为|本课题。|和示例|完全|这些|条件|三|(穆罕默德)|从|你说:|(默罕默德|是目前)|然后当然它|是一个名词|主格|非|它之前|原因/因素/主动元素|语言/发音/口腔。|和谓词:|它是|名词|主格|其中|是/连接|到|主题|并同意|在其上，|然后是完整|它的|与它|这次演讲|和它的例子|(目前)|从|你说:|(默罕默德|目前)。|和执政的|每个|从|主题|和谓词|主格|像什么作为|你看到，|与此|主格|作为为|那| Yin|与 damma|很明显，|就像|(真主|是我们的主)|并且|(默罕默德|是我们的先知)|至于|那| Yin|主格|与 damma|应该|为不可能的事|就像|(Moses|是选择/选择一|从|安拉)|就像|(蕾拉|是最好的|女孩)|至于|那| Yin|与 damma|应该|防止|从|其明显|困难|就像|(法官| Yin|来)。|至于|那| Yin|主格|一封信|从|字母|其中|替代品|从|damma|就像|(两个硬-工人|是成功的)。|肯定|必须很重要|in|主题|和谓词|那|如下|in|单数|就像|(默罕默德|是站)|和双|就像|(两个穆罕默德|站)|和复数|就像|(穆罕默德|站)|中和|男子气概|像这些|例子，|中和|女性气质|就像|(后腿|是站)|并且|(两个不要惊动|站)|并且|(不要惊动|站)。
GreatMasterpiece49=主题|有两个部分:|表观|和隐藏|它说:|和主题|有两个部分:|很明显，|和隐藏;|然后明显|什么|来之前|其一提，|隐藏|二|十、|和他们是:|我，|我们，|你阳刚，|你女性，|你们两个，|你所有男性，|你所有的女性，|他，|她，|他们两个，|他们阳刚，|他们女性，|就像|你说:|(I|站)|并且|(我们|站)|和什么|是类似于|那。|我说:|划分|主题|into|两个部分:|第一|很明显，|和第二个|隐藏，|和肯定|以前|in|这一章|活动元素的|你理解|每个|从|表观|和隐藏。|然后示例|主题|表观|(默罕默德锯|是的使者|真主)|并且|(RA Aisha|是母亲|信徒)|和主题|隐藏|二|十|表达式。|第一:|() i|扬声器/第一人|一个人，|就像|(I|我的仆人|真主)。|第二种:|(我们)|扬声器/第一人|multiple|或者|一|制作很重要|自己，|就像|(我们|站)。|第三:|(你阳刚)|为解决/二人|单数|男性，|就像|(你阳刚|理解)。|第四:|(你女性)|为解决/二人|单数|女性，|就像|(你女性|都是听话)。|第五:|(你们两个)|两个处理/二人|男性|was|或者|女性，|就像|(你两个男性|站)|并且|(你两个女性|站)。|第六:|(你所有男性)|为复数|男性|第二个人，|就像|(你所有男性|站)。|第七:|(你所有女性)|为复数|女性|第二个人，|就像|(你所有女性|站)。|第八:|(他)|为单数|其他/三人|男性，|就像|(他|正在执行|他的职责)。|第九届:|(她)|为单数|女性|其他/三人，|就像|(她|旅游)。|第十届:|(他们两个)|为双|其他/三人|不受限制，|男性|was|或者|女性|就像|(两个男性|站)|并且|(两个女性|站)。|第一|十:|(他们阳刚)|为复数|男性|其他/三人，|就像|(他们阳刚|站)。|第二个|十|(他们女性)|为复数|女性|其他/三人，|就像|(他们女性|站)。|如果|was|主题|代词|然后当然它|非| Yin|除了|明显明显|分离，|诸如此类|你看见。
GreatMasterpiece50=部分|谓词的|它说:|和谓词|有两个部分:|单数;|和其他比|奇异，|然后是单数|就像:|(宰|是站)|和其他比|单数|四|事情:|介词|和它支配这个词在所有格形式，|和间接言语名词，|和动词|带有|其积极的元素，|和主题|带有|其谓语|就像|你说:|(宰|在|房子，|和 Zayd|就在附近/你，|和 Zayd|是站|他的父亲，|和 Zayd|他女性的奴隶/阿比盖尔|去)。|我说:|划分|谓词|到|两个部分:|第一|谓词|奇异，|和第二个|谓词|其他比|奇异。|和的意思|由奇|在这里:|什么|不是|一个句子|而不是|准/类似于|句子，|就像|(站)|从|你说:|(默罕默德|是站)。|和其他比|单数|两种类型:|一个句子|和准|句子。|和这句话|两种类型:|一个句子|名义上，|和一个句子|口头。|然后这句话|名义上:|什么|是由组成/撰写|从|一门学科|和谓词|就像|(他的父亲|是慷慨)|从|你说:|(默罕默德|他的父亲|是慷慨的)。|和这句话|语言:|什么|是由组成/形成/建造/撰写|从|动词|和活动元素|或者|其替代物，|就像|(旅行|他的父亲)|从|你说:|(默罕默德|旅行|他的父亲)|就像|(被击中|他的儿子)|从|你说:|(哈立德|被击中|他的儿子)。|因此，如果|was|谓词|一个句子|然后一定要|为它|从|连接|连接它|这一主题，|作为为|代词|返回|到|主题|像什么|你听说过|in|该示例|至于|名词|指向示范 /|就像|(默罕默德|此|是一个人|慷慨而定)。|和准|句子|两种类型|此外，|第一:|介词|和它支配这个词在所有格形式，|就像|(在|这座清真寺)|从|你说:|(阿里|在|这座清真寺)|和第二个:|名词，|就像|(以上|分公司)|从|你说:|(这只鸟|以上是|分支)。|从|那|你知道的|那|谓词|是时|详细信息|五|部件:|奇异，|和一个句子|口头，|和一个句子|名义上，|和一个介词|和它所管治的话语在所有格形式，|和名词。|练习|upon|拐点|活用|句子|给出:|默罕默德|站，|默罕默德|出席|他的父亲，|默罕默德|他的父亲|正在旅行，|默罕默德|在|房子，|默罕默德|是的/靠近你。|响应/答案|1-|默罕默德|是站|-|默罕默德:|主题|主格|与初始，|和标志|它主格的|damma|in|它的结局，|站:|谓词|为主题|主格|这一主题，|和标志|它主格的|damma|表观|in|它的结束。|2-|默罕默德|出席|他的父亲|-|默罕默德:|一门学科，|出席:|一个动词|过去时态|结构|upon|罚的骂|非|一个地方|为它|从|屈折变化，|父亲:|活动元素|出席，|主格|带有 waw|更换|从|damma|因为它|是从|名词|五、|和父亲|是附加的所拥有的|和 haa|是拥有/附加|到它，|结构|upon|damma|in|地方|所有格，|和这句话|从|动词|和活动元素|in|地方|主格的|是谓语|问题，|和连接|介于|主题|和谓词|它是|代词|发生|拥有/附加|到它|in|你说:|(他的父亲)。|3-|默罕默德|他的父亲|旅行|-|默罕默德:|一门学科|第一个|主格|与 damma|很明显，|和父亲:|一门学科|第二个|主格|带有 waw|更换|从|damma|因为它|是从|名词|五、|和父亲|是附加的所拥有的|和 haa|拥有/附加|到它，|旅游:|谓词|主题|第二，|和这句话|主题|第二个|并且|其谓语|in|地方|主格的|谓词|主题|第一，|和连接|介于|这句话|和主题|第一个|代词|其中|在|你说:|(他的父亲)。|4-|默罕默德|在|这房子|-|默罕默德:|一门学科，|在|房子:|介词|和那些它支配/使所有格|相关|与删除|谓词的|主题。|5-|默罕默德|是的/靠近你|-|默罕默德:|一门学科，|旁边:|名词|地方|相关|与删除|谓词的|问题，|和通过或其附近:|附加所拥有，|和 kaf|代词|每秒处理人|连接藏有|到它|结构|upon|罚的骂|in|地方|所有格。|练习/演习|1-|请参阅|主题|和谓语，|和类型|每个|一|从他们，|从|介于|单词|发生|in|句子|给出，|如果|was|谓词|这句话的|然后之间|连接|它之间|和之间|本课题。|勤奋的工人|获取|他的目标，|驱动程序|较强|in|旅行/旅行，|棕榈树|生产|它的果实|每隔|年|有一次，|信徒|荣耀|真主，|你的书|是干净的|此|笔|是从|木头，|羊毛|是采取|从|羊，|和发毛皮|从|骆驼，|这双鞋|都是|从|皮革|山羊的|和其他人或其它比它，|锅内|位于|火，|尼罗河|灌水的水域|这片土地|埃及的|您|了解|这其中|有利于你，|你的父亲|那个谁|花|在你身上，|你的母亲|是最值得|人|你的顺服，|麻雀|唱着|上方|这棵树，|发光|如下|雨中，|穷人或贫穷的人|是一个人|剥夺了|他自己|虽然他是|找到，|我的朋友|他的父亲|是他，|我的父亲|与他有|一匹马，|我的兄弟|对他来说有|是一辆车。|2-|用|每个|名词|从|名词|给出了|一门学科|in|两个句子|有意义，|所以| Yin|其谓语|in|一|从这两个|单数|中和|第二|一个句子:|这两个学生，|默罕默德，|水果，|西瓜，|这支笔，|这本书，|该研究所|尼罗河|阿伊莎，|两个女孩。|3-|使谓词|从|每个|名词|从|名词|给出了|与准|句子:|麻雀，|绒面，|亚历山德里亚，|开罗，|这本书，|椅子上，|这条河|尼罗河。|4-|地方|为每个|介词|和那些它支配/使所有格|用什么|如下|一门学科|适当的|完成|由它|与它|演讲:|in|笼子里，|附近的|这座山|穆盖塔姆，|从|木头，|upon|岸/滩|海，|从|羊毛，|in|包里的东西|in|方向|西|在|开罗。|5-|建造|三|句子|in|描述|骆驼的|包括|每个|一|从他们|upon|主题|和谓词。|问题|此培训完成后，受众能够做些什么?| Yin|会议的议题?|此培训完成后，受众能够做些什么?| Yin|谓语?|进入|几个|部件|划分|会议的议题?|生成|为主题|很明显，|闭合|为主题|隐藏，|into|几个|部件|划分|隐藏|其中|位于|会议的议题?|进入|几个|部件|划分|谓词|句子吗?|进入|几个|部件|划分|谓词|准|句子，|什么|其中|connects|谓词|这句话的|与主题?|输入|其中|事|答案|匹配|谓词|为主题吗?|生成|为每个|类型|从|类型|谓词的|两个例子。
GreatMasterpiece51=取消/annuller|主题|和谓词|它说:|(章|功能/元素/致使概念|进入|upon|主题|和谓词)|和他们是|三|事情:|动词是|和它的姐妹，|和宾格粒子当然可以|和它的姐妹，|我想|和它的姐妹。|我说:|当然|你知道的|那|主题|和谓词|两个主格例。|知道|它|当然|进入|在这两个|一|因素/积极的元素|表达/口述|然后更改|其两个的屈折变化，|和这些|因素|其中|Enter|在这两个|CHANGES|其拐点|-|之后|关注|这次演讲|阿拉伯人的|值得信赖可靠|与 it(investigation/exploration)|-|upon|三|部件:|第部分|第一:|它使主格|主题|和使宾格|谓词，|这是|be/(was) 对动词|和它的姐妹，|与此|部件|他们每个人都|是动词，|就像|(是|天气|清除)。|第部分|第二:|它使宾格|主题|和使主格|谓词，|相反|第一，|和那|宾格 particle/(certainly)|和它的姐妹|和那|第部分|喜欢它|颗粒，|就像|(实在|真主|是最强大|大多数的 Wise)(2:220)。|第部分|第三:|它使宾格|主题|和谓词|在一起，|和那|(我以为)|和它的姐妹/亲戚，|与此|部件|喜欢它|动词，|就像|(我以为|朋友|是的哥哥)。|并要求|这些|元件|(对消器/annuller);|因为他们|废除/取消|这项裁决|主题|和谓语，|其中:|它更改/更新它们|发现|对他们来说|裁决|另一个|其他比|他们两个的裁决|第一次。
GreatMasterpiece52=动词是|和它的姐妹|它说:|然后为|be/(was) 对动词|和它的姐妹，|然后当然它|使得主格|名词，|和使宾格|谓词，|和他们是:|动词是，|和它在夜晚，成为了|和它变成 / 早晨，成为|和它在那天上午，成为了|和他保持的所成为的|和它在夜晚成为了/他花留夜/一夜之间，|它变成了，|而不是|还有 (继续)|他是|并不是保持|他是停止某事，|和不/不断|他是停止某事，|和仍然/继续|他是|而且只要|他剩余，|和什么|推导出|从他们|就像:|他是，|他是|和，|和他成为了/它成为了早晨，|和他成为/它变得早晨，|成为 (上午)|你说:|(是|宰|站，|并不是|Amr|凝视着/看了一眼眼中)|和什么|是类似|到那。|我说:|第部分|第一个|从|取消/废止|主题|和谓词|be/(was) 对动词|和它的姐妹，|其中:|类似/等于它|in|功能。|与此|部件|进入|upon|主题|所以它删除|它主格|第一次 (原因)|并给出了|为它|主格|新 (原因)，|和电话|主题|其名词，|进入|upon|谓词|然后使宾格|和电话|其谓词。|与此|部件|三|十|动词:|第一:|(是) / 动词是|和它|是指|描述|名词的|与谓词|in|过去时态，|对于|带有|停用结论|就像|(是|默罕默德|一个勤劳的工人)|对于|带有|连续性/连续性，|就像|(和是|你的主|所有的 powerful)(25:54)。|和第二个:|(它成为了在晚上)|和它|是指|描述|名词的|与谓词|in|晚上，|就像|(成为在晚上|天气|冷)。|和第三个:|(早晨成为了)|和它|是指|描述|名词的|与谓词|in|早晨，|就像|(早晨成为了|天气|多云/阴)。|和第四个:|(在午前成为了)|和它|是指|描述|名词的|与谓词|in|那天上午，|就像|(在午前成为了|学生|处于活动状态)。|和第五个:|(他仍然成为/变更)|和它|是指|描述|名词的|与谓词|in|整个|白天，|就像|(变得|他的脸|darkened)(43:17)。|而第六:|(他花了晚上/呆一夜)|和它|是指|描述|名词的|与谓词|in|夜晚的时间|就像|(支出夜/住一夜|默罕默德|快乐)。|和第七个:|(它改变了)|和它|是指|变化|名词的|从|其条件|到|状态|其中| Yin|在上面|谓词，|就像|(成为了|粘土|一壶)。|和第八:|(它不是)|和它|是指|否定|谓词的|从|名词|in|时间|目前，|就像|(不是|默罕默德|理解)。|第九次|和第十届|和第一次|后十|和第二个|后十:|(和仍然 (继续)|他是)|并且|(并不保持|他是停止某事)|并且|(和不/不断|他是停止某事)|并且|(和仍然/继续|他是)，|和这些|四|参考|upon|以下|谓词的|该名词|根据|要求|条件下，|就像|(仍未|接受/申明|亚伯拉罕 ·|邪恶)|就像|(还不|停止/不再|阿里|一位朋友|真诚)。|第三个|后十|(只要|他是)|和它|是指|以下|谓词的|该名词|还|就像|(不|我责怪|哈立德|只要|我是|活着)。|并且划分|这些|动词|-|从|侧/关于|行动/函数|-|到|三|部件:|第部分|第一:|什么|让|此|操作|-|它是|主格|名词的|和宾|谓词的|-|与条件|正在启动|(只要)|动词不定式|副词|在上面|它是|一个动词|一|它是|(他剩余)。|第部分|第二:|什么|让|此|操作|与条件|那|开始时间|在上面|否定，|或者|质疑，|或者|禁止，|和他们是|四|动词，|和他们是:|(他是)|并且|(他是停止某事)|并且|(他是停止某事)|并且|(他是)。|第部分|第三:|什么|让|此|操作|无|条件，|和他们是|八|动词，|和他们是|剩下。|并且划分|这些|动词|从|状态|变化|into|三|部件:|第一|部分:|这其中|推导出|in|动词|拐点|完成，|与意义|它|来自|从它|过去时态|和现在时态|和命令紧张，|它是|七|动词，|和他们是:|动词是，|和它在夜晚，成为了|和它变成 / 早晨，成为|和它在那天上午，成为了|和他保持的所成为的|和它在夜晚成为了/他花留夜/一夜之间，|和它变成。|和部分|第二:|这其中|推导出|in|动词|拐点|不完整，|与意义|它|来自|从它|过去时态|和现在时态|非|其他，|它是|四|动词，|和他们是:|他是|和他是停止某事，|和他是停止某事，|和他是。|第部分|第三:|这其中|非|反映|源语言|它是|两个动词:|两个之一|(不是)|由协议|和第二个|(他剩余)|upon|最正确。|和其他|过去时态|从|这些|动词|执行|功能|过去式，|就像|你说:|最高:|(而不是|他们停止|differing)(11:118)，|(永远不会|我们将停止|在上面|被 devoted)(20:91)，|(由真主|你不会停止|记住|Joseph)(12:85)。
GreatMasterpiece53=当然跟宾格助词|和它的姐妹|它说:|和|当然宾/粒子|和它的姐妹|然后当然它|让宾格|名词|和使主格|谓词，|和他们是:|当然/的确/实在，|而且，|但是，|好像，|希望 / 如果只，|也许，|你说:|实在|扎伊德|站，|我希望|Amr|被盯着看的所凝视的|和什么|类似|到它，|和意义|肯定|和那|强调，|但|为校正/整改/对供应的是缺掉的|因为如果|相比之下，|和想要是|祝福，|也许|希望|和期望。|我说:|第部分|第二个|从|取消/废止|主题|和谓词|(实在) / 宾格粒子|和它的姐妹，|其中:|类似/等于它|in|功能，|和它|进入|upon|主题|和谓语，|然后使宾格|主题|和电话|其名词，|和使主格|谓词|-|与意义|它|更新|为它|nominativeness|其他比|其中|was|为它|之前|它的条目|-|和电话|其谓语|和这些|文书|他们每个人|颗粒，|和他们是|六:|第一|(当然/实在/真实地)|与 kasra|哈姆扎。|和第二个|(，)|与罚的骂|哈姆扎。|和他们两个|参考|upon|强调，|及其意义|加强|关系/归因|谓词的|到问题时，|就像|(肯定|你的父亲|参加)，|就像|(我知道|那|你的父亲|旅游)。|第三个|(但是)|及其意义|校正|它是|继承|字|与否定|其中|被视为|其确认|或者|确认|其中|被视为|它的否定，|就像|(默罕默德|是勇敢|but|他的朋友|是懦夫/胆小者)。|第四|(好像)|和它|是指|upon|比较|主题|与谓词，|就像:|(这是因为如果 / 看起来像|那个女孩|一轮满月)。|第五个|(希望要是)|及其意义|许愿，|和它是:|请求|不可能|或者|什么|在它|困难，|(我希望|青年|可以返回)|就像|(我希望|愚蠢的白痴/人|要通过)。|第六|(也许)|和它|是指|upon|希望|或者|由于担心及期望，|和意义|希望:|请求|一件事...|喜欢，|而不是| Yin|除了|in|可能性|就像:|(也许|真主|将怜悯我)|和意义|担心/期待:|期待|发生|一件事|不喜欢|in|本身，|就像:|(也许|敌人|是密切|给我们)。
GreatMasterpiece54=他思想双宾动词|和它的姐妹|它说:|和|我思想双宾动词|和它的姐妹|然后当然它|让宾格|主题|和谓词|upon|那两个|采取行动|对他们来说，|和他们是:|我思想/相信/认为，|和我思想/相信/认为，|和我思想/相信/认为，|和我思想/相信/认为，|我知道，|我知道，|而我发现，|和我了，|和我做了，|并听取了;|你说:|我以为|宰|站起来了，|我看见|Amr|凝视所看，|和什么|是类似|到那。|我说:|第部分|第三个|从|对消器/annuller|主题|和谓语，|(我以为)|和它的姐妹|其中|类似/等于|in|功能，|和他们|Enter|upon|主题|和谓词|然后使二者宾格|在一起，|它是说|为主题|采取行动|第一个|和谓词|采取行动|第二，|与此|部件|十|动词:|第一|(我以为)|就像|(我以为|默罕默德|是朋友)。|和第二个|(我以为)|就像|(I 思想/认为/相信|把财富|是有用有益)。|第三个|(我以为)|就像|(I 思想/认为/相信/声称|花园里|是富有成果)。|第四|(我以为)|就像|(我以为|巴克尔|是勇敢)。|第五个|(我知道)|就像|(我知道/认为/相信/思想|亚伯拉罕 ·|是成功的)。|第六|(我知道)|就像|(我知道|朋友|抢救)。|第七个|(我发现)|就像|(我发现|义|是那扇门|善良)。|和第八|(花了)|就像|(我用了|默罕默德|作为一个朋友)。|第九次|(我做了)|就像|(我做了|黄金|成圈)。|和第十届|(听说)|就像|(我听说|哈利勒|阅读)。|这些|动词|十|除|到|四|部件:|第部分|第一:|它是指|概率|发生|谓词的|它是|四|动词，|和他们是:|我思想/相信/认为，|和我思想/相信/认为，|和我思想/相信/认为，|和我思想/相信/认为。|和部分|第二:|它是指|定罪适|和确认|发生|谓词的|它是|三|动词，|和他们是:|我知道，|我知道，|而且我发现。|和部分|第三:|它是指|移交|和移动，|它是|两个动词，|和这两个是:|我花了，|和我做了。|和部分|第四:|它是指|有关/归因|in|听证会上，|它是|一个动词|一个人，|它是|听到了。|练习/演习|1-|Enter|动词是 /(was)|或者|一|它的姐妹|upon|每个|句子|从|句子|给出了|然后|放|结局|每个|Word|与元音的迹象。|天气|是阳光明媚万里无云。|卫兵/看守员|是清醒的。|空气|是新鲜的。|花园里|是卓有成效的。|园丁|是醒/警报/小心。|读取|是有用的。|真相|是有益的。|天课/慈善机构|是强制性/强制/必不可少。|太阳|太热了。|寒冷|是严重激烈。|2-|Enter|(实在) / 宾格粒子|或者|一|它的姐妹|upon|每个|句子|从|句子|给出，|然后|放|与元音迹象|结束|每个|词:|我的父亲|将要参加会议，|你的书|是新的|你的墨水瓶|很脏，|你的钢笔|坏了，|你的手|是干净的|这本书|是一个很好|朋友，|人品的举止|是值得称赞的|蜜瓜/西瓜|将出现|in|夏天，|橙色|属于|水果|冬天，|棉花|是的原因|为财富|埃及的|尼罗河|是新鲜/愉快|水，|埃及|它的土壤|是好|农业/生长。|3-|Enter|(他认为) / 双宾动词|或者|一|它的姐妹|upon|每个|句子|从|句子|给出，|然后|放|与元音迹象|结局|每个|词:|默罕默德|是你的朋友，|你的父亲|是最受喜爱|人的人|给你，|你的母亲|是最富有同情心的/仁慈|人的人|与你，|域|是盛开的所兴起的|花园里|是卓有成效的|今年夏天|灼热，|朋友|是你的帮手|带有|困难和难度，|沉默|好/漂亮，|服装|白色|是的衣服|整个夏季，|滑倒/跌跌撞撞|舌头的|更糟糕的是|比从|滑倒/跌跌撞撞/跳闸|脚。|4-|付诸表决|in|这个地方|空闲|从|每个|示例|从|例子|给出了|一个字|适当情况下，|并将其放置|与元音符号:|(裁决)|肯定|警卫队/看守员|......|() b|变得|天课/慈善机构|......|() c|在午前成为了|太阳|......|() d|我知道|朋友|......|() e|肯定|滑倒/跌跌撞撞|舌头的|......|() f|我知道|那|这本书|......|() g|默罕默德|是我的朋友|but|他的弟弟|......|() h|我知道|你的父亲|......|() i|在这一天成为了|天气|......|() j|看起来像|域|......|() k|我知道|你的叔叔|......|() l|我以为|那|棉花|......|() m|在晚上成为了|空气|......|() n|我听说过|你的兄弟|......|() o|仍|记得|亚伯拉罕 ·|......|() p|我会和你交朋友|还是一样|你是|......|() r|好|语音|是从|标志|成功的|but|沉默|......|5-|地方|检测|从|文书|取消/撤消判决的|让宾格|这个地方|in|每个|地方|空闲|从|例子|给出:|(裁决)|......|这本书|是一个很好|娱乐/艺人。|() b|......|天气|沉重|云豹/阴。|() c|......|真实性|以求安全。|() d|......|你的兄弟|是真实的|对我来说。|() e|......|你的兄弟|我的同学|in|学校。|() f|......|警卫队/看守员|清醒。|() g|......|老师|一个指南。|() h|......|天堂|谎言背后|双脚|你的母亲。|() i|......|女儿|一所学校。|() j|......|这本书|我娱乐/每晚的同伴。|() k|......|好友|你的帮助|in|困难和难度。|6-|付诸表决|in|地方|空闲|从|每个|示例|从|例子|给出了|一个名词|并将其放置|与元音迹象|完成:|(裁决)|was|......|全能者/无所不能。|() b|过夜|......|不信道的人。|() c|我看见|......|在黑暗/阴云密布的天空。|() d|我知道|那|公平/公正|......|() e|变得|......|面包|......|() f|不是|......|脱下衣服/被剥夺/剥去。|() g|在晚上成为了|......|快乐。|() h|当然|......|盛开的明亮。|() i|但愿|......|是/出现上升的。|() j|看起来像|......|老师。|() k|非|在停止为|......|我的朋友。|() l|实在|......|是强制性的。|7-|生成|三|句子|in|描述|这本书的|每个|一|包括|upon|一门学科|和一个谓语|然后|Enter|upon|每个|句子|从它|(是)|和地方|它的词|与元音的迹象。|8-|生成|三|句子|in|描述|下着雨|每个|一|包括|upon|一门学科|和一个谓语|然后|Enter|upon|每个|句子|从它|(肯定)|和地方|它的词|与元音的迹象。|9-|生成|三|句子|in|描述|这条河的|每个|一|包括|upon|一门学科|和一个谓语|然后|Enter|upon|每个|句子|从它|(我知道)|和地方|它的词|与元音的迹象。|练习/演习|upon|拐点|活用|句子|给出:|事实上|亚伯拉罕 ·|was|nation(16:120)|类似于|月亮|一盏灯，|我认为思想 /|金钱|正如有用/有益，|仍然不|停止|这本书|我的朋友/同伴。|对答案|1-|事实上:|一个粒子|重点|和宾格|让宾格|名词|和使主格|谓词，|和亚伯拉罕:|名词|的确宾/粒子|宾格|通过它，|和标志|其宾格的|罚的骂|很明显，|是:|一个动词|过去时态|不完整，|使得主格|名词|和使宾格|谓词，|和它的名词|代词|隐藏|在它|允许|其所谓| Yin|返回|upon|亚伯拉罕，|国家:|谓词|是动词是|宾格|通过它，|和标志|其宾格的|罚的骂|很明显，|和这句话|从|是动词是|和它的名词|和谓语|in|地方|主格的|谓词|(事实上宾/粒子)。|2-|就好像:|一个粒子|相似的|和宾格|让宾格|名词|和使主格|谓词，|和月亮:|名词|仿佛 / 宾格粒子|宾格|通过它，|和标志|其宾格的|罚的骂|很明显，|和一盏灯:|谓词|仿佛 / 宾格粒子|主格|通过它，|和标志|它主格的|damma|明显。|3-|想法|一个动词|过去时态|结构|upon|罚的骂|应该|upon|它的结局|防止|从|其明显|运作|这个地方|与苏坤|反向门|为排斥|不喜欢|分别|四|vowelled 字母|在什么| Yin|像这个词|一个人，|及 taa|代词|一位发言者的/第一人|活动元素|思想/双宾动词，|结构|upon|damma|in|地方|主格的|财富:|谓词|第一个|思想/双宾动词|宾格|通过它，|和标志|其宾格的|罚的骂|很明显，|和有用有益:|谓词|第二个|思想/双宾动词|宾格|通过它，|和标志|其宾格的|罚的骂|明显。|4-|不是:|一个粒子|否定之否定|结构|upon|苏坤|非|一个地方|为它|从|屈折变化，|仍停止:|一个动词|过去时态|不完整|使得主格|名词|和使宾格|谓词，|这本书:|名词|仍停止|主格|通过它，|和标志|它主格的|damma|表观|in|它的结局，|朋友/伴侣:|谓词|仍停止|宾格|通过它，|和标志|其宾格的|罚的骂|应该|in|它的结局|防止|从|其明显|函数|这个地方|与元音迹象|适当的|对呀|演讲者/第一人称，|和朋友/伴侣|拥有/附加|和严|一位发言者的/第一人|拥有|连接的|到它|结构|upon|苏坤|in|地方|所有格。|问题|后|部件|取消/撤消判决的|几个|部件|划分|取消/废止吗?|此培训完成后，受众能够做些什么?|其中|行为|是动词是|和它的姐妹吗?|进入|几个|部件|划分|这对姐妹的|(是) / 动词是|从|侧面|功能吗?|成|几个|部件|划分|从|侧面|拐点?|此培训完成后，受众能够做些什么?|其中|行为|(当然) / 宾格粒子|和它的姐妹吗?|此培训完成后，受众能够做些什么?|其中|是指|在上面|就好像|和希望?|此培训完成后，受众能够做些什么?|意思是|校正吗?|此培训完成后，受众能够做些什么?|意思是|希望吗?|此培训完成后，受众能够做些什么?|意思是|担心及期望?|此培训完成后，受众能够做些什么?|其中|行为|(我思想/双宾动词|和它的姐妹) 吗?|进入|几个|部件|划分|这对姐妹的|(我思想/双宾格助词) 吗?|给|三|句子|组成|从|一门学科|和一个谓语|所以| Yin|第一|从|一门学科|很明显，|和谓词|句子|口头，|和第二个|从|一门学科|代词的|为复数|男性|和谓词|奇异，|第三个|从|一门学科|表观|和句子|名义上，|然后|Enter|upon|每个|一|从|这些|句子|(是)|并且|(也许)|并且|(我认为)。|活用|句子|给出:|(和花了|真主|亚伯拉罕 ·|作为亲密的 friend)(4:125)|(我希望的 O|我死了|之前|this)(19:23)|(可能会|范围|ways)(40:36)。
GreatMasterpiece55=形容词|它说:|(章|形容词)|形容词:|一个追随者|被描述的词|in|它主格|和其宾格|和它的所有格，|和确定性|和不确定性;|站在|宰|智能，|我看见|宰|智能，|和我通过|由扎伊|智能化。|我说:|描述性的名词/属性|in|语言的意义|它是|形容词，|中和|术语|语法意义|它是:|从动件|衍生品的|或者|什么被解释|作为衍生工具，|澄清|以下|in|确定性，|指定|为它|in|不是确定性。|形容词和|划分|到|两个部分:|第一:|形容词|真实，|和第二个:|形容词|证明/激励/偶尔。|对于|形容词|True|然后是:|这其中|由主格|代词|隐藏|返回|到|被描述的词|就像|(来了|默罕默德|有头脑的/智慧)|然后头脑/聪明:|形容词|穆罕默德的|它是|制作主格|为代词|隐藏|其隐含|它是|返回|到|默罕默德。|和|形容词|偶尔|然后是:|这其中|由主格|名词|表观|连接的|用代词|返回|到|被描述的词|就像|(来了|默罕默德|良性|他的父亲)|然后良性:|形容词|穆罕默德的|和他的父亲:|活动元素|为良性，|主格|带有 waw|更换|从|damma|因为它|是从|名词|五、|它是|附加/拥有|到|haa|其中| Yin|代词|返回|到|默罕默德。|和执政的|形容词的|它|如下|它描述了这个词|in|屈折变化，|中和|确定性|或者|不是确定性，|是否|was|True|或者|偶尔。|和意义|此|它|If|was|被描述的词|主格|was|形容词|主格，|就像:|(出席|默罕默德|杰出的/义人)|或者|(出席|默罕默德|优秀的义人 /|他的父亲)|如果|was|被描述的词|宾格|was|形容词|宾格|就像:|(我见过|默罕默德|杰出的/义人)|或者|(我见过|默罕默德|优秀的义人 /|他的父亲)|如果|was|被描述的词|所有格|was|形容词|所有格，|就像:|(我看|toward|默罕默德|杰出的/义人)|或者|(我看|toward|默罕默德|优秀的义人 /|他的父亲)|如果|was|被描述的词|正定|was|形容词|明确，|像什么|in|组|例子|以前，|如果|was|被描述的词|无限期|was|形容词|无限期，|就像:|(我见过|一个男人|智能/wise)|或者|(我见过|一个男人|智能/智慧|他的父亲)。|然后|If|was|形容词|True|增加|upon|那|它|如下|被描述的词|in|其男子气概|或者|其女性气质，|中和|其 singularness|或者|其对偶性|或者|其多元化。|和意义|那|它|If|was|被描述的词|男性|was|形容词|男性，|就像|(我见过|默罕默德|智能/wise)|如果|was|被描述的词|女性|was|形容词|女性|就像:|(我见过|法蒂玛|有礼貌)|如果|was|被描述的词|单数|was|形容词|单数|像什么|你看见|in|这两个|例子，|如果|was|被描述的词|双|was|形容词|双，|就像:|(我见过|两个穆罕默德|智能/wise)|如果|was|被描述的词|复数|was|形容词|复数，|就像:|(我见过|男子|智能)。|对于|形容词|偶尔|然后当然它| Yin|单数|permanent|如果|was|它被描述的词|双|或者|复数|你说:|(我见过|这两个男孩|智能化|两个父亲)|和你说:|(我见过|男孩子们|智能化|他们的父亲)|和如下|形容词|偶尔|什么|在它之后是|in|男子气概|或者|女性，|你说:|(我见过|女儿|智能化|他们的父亲)，|和你说:|(我见过|男孩子们|智能化|他们的母亲)。|然后指定|从|此|解释/澄清|那|形容词|True|如下|它被描述的词|in|四|从|十。|一个|从|单数|和双|和复数，|和一个人|从|主格|和宾|和所有格，|和一个人|从|男子气概|和女人味，|和一个人|从|确定性|和不确定性。|形容词和|偶尔|如下|它被描述的词|in|二|从|五:|一|从|主格|和宾|和所有格，|和一个人|从|确定性|和不确定性，|和如下|它主格|其中|在它之后是|in|一|从|二|两个是|男子气概|和女人味，|而不是|如下|所有内容|in|singularness|和对偶|与多元化、|当然| Yin|单数|永久|一直到永远，|和阿拉|知道。
GreatMasterpiece56=确定性|和它的零件|它说:|确定性|五|事情:|名词|隐含的代名词形式|就像:|I|和你，|和名词|正确|就像:|宰|和麦加，|和名词|模糊/不清楚/示范|就像:|这个男性|和这个女性|而这些，|和名词|其中|在它|阿利夫|和林|就像:|男子|和那个男孩，|和什么|附加|到|一|从|这些|四。|我说:|知道|那|名词|划分|into|两个部分，|第一:|无限期。|它会来。|和第二个:|确定|和它是:|表达式|其中|是指|upon|具体/已知的东西，|和它的零件|有五项:|第部分|第一:|暗示 pronounal 窗体|或者|代词，|它是|什么|是指|upon|一位发言者/第一人称，|就像:|我，|或者|每秒处理人|就像:|你阳刚，|或者|另一个/缺席/离开三分之一人|就像:|他，|和从|此处|你知道的|那|代词|是三个|种。|那种|第一:|这其中|使用|以指示|到|演讲者/第一人|它是|两个字，|和这两个是:|() i|扬声器/第一人|独自一人，|并且|(我们)|扬声器/第一人|小菊|他自己|或者|与他|除了他的是。|和那种|第二:|这其中|使用|以指示|upon|每秒处理人|它是|五|表达式，|和他们是:|(你阳刚)|与罚的骂|tah 的|为解决/二人|男性|奇异，|并且|(你女性)|与卡斯里|tah 的|为解决/二人|女性|单数|并且|(你们两个)|为解决/二人|双|男性|was|或者|女性|并且|(你所有男性)|为复数|男性|每秒处理的人，|并且|(你所有女性)|为复数|女性|每秒处理的人。|和那种|第三:|这其中|使用|以指示|upon|其他/三人，|它是|五|表达式|此外，|和他们是:|(他)|其他/三人|男性|奇异。|与|(她)|其他/三人|女性|奇异，|并且|(二)|为双|其他/三人|不受限制，|男性|was|或者|女性，|并且|(他们阳刚)|为复数形式|男性|其他/三人，|并且|(他们女性)|为复数形式|女性|其他/第三人。|以前|此|解释|in|这项研究|活动元素的|中和|这项研究|主题|和谓词。|第部分|第二个|从|明确:|正确，|它是|什么|是指|到|具体的东西|无|需要 / 要求|对于|连接|对一位发言者/第一人|或者|每秒处理人|或者|其他比两个，|它是|两种:|男性|就像|(穆罕默德)|并且|(亚伯拉罕)|并且|(装载)|和女性|就像|(法蒂玛)|并且|(赞)|并且|(麦加)。|第部分|第三:|名词|目前还不清楚/含糊不清，|它是|两种:|名词|示范，|和名词|相对的 pronounal 形式。|对于|名词|示范:|然后是:|这其中|使用|用于引用|upon|具体/明确的东西|通过手段|信号/显示|感官|或者|抽象的意义，|和为它|表达式|特定物体|和它是:|(此男性)|对于男性|奇异，|并且|(这是女性)|为单数|女性，|并且|(这些两个男性)|或者|(这些两个男性)|为双|男性，|并且|(这两个女性)|或者|(这两个女性)|为双|女性，|并且|(这些)|为复数形式|不受限制。|和|名词|相对|然后是:|这其中|是指|upon|具体/明确的东西|通过手段|句子|或者|类似于它。|它被提到|在它以后|肯定|它被称为|关系从句合成关系，|它是|关注|upon|代词|匹配|相对|它被称为|返回/归属，|和为它|表达式|特定|此外，|和他们是:|(男性一个谁)|为单数|男性。|与|(女性一个谁)|为单数|女性，|并且|(两个男性谁)|或者|(两个男性谁)|为双|男性，|并且|(女性两人的)|或者|(女性两人的)|为双|女性，|并且|(那些男性谁)|为复数|男性|并且|(那些女性谁)|为复数|女性。|第部分|第四:|装饰/开始|alef|和林|和它是:|每个|名词|已连接|与它|()|那么它将使我们|明确;|就像|(人，|和这本书，|和那个男孩，|和女孩)。|和部分|第五:|名词|其中|附加|到|一|从|四|上一页|所以它就有了|确定性|从|附加/拥有|到它，|就像|(你的男孩)|并且|(男孩|默罕默德)|并且|(男孩|这|人)|并且|(男孩|那个谁|我们参观了|昨天)|并且|(男孩|老师)。|最明确|这些|界定|之后|表达式|陛下:|代词|然后|专有名词，|然后|名词|指向/论证、|然后|名词|相对，|然后|放置从开始|与确定性文章|然后|附加/拥有|到它。|和附加/拥有|in|同一级别|附加/藏|到它，|除了|附加/拥有|到|代词|然后当然是|in|同一级别|专有名词，|和阿拉|最了解情况。
GreatMasterpiece57=不确定|它说:|和不确定:|每隔|名词|一般/常用|in|其性别|非|指定|与它|一|无|其他，|和其密切的理解:|全部|那|使用|条目|alef 的|和林|在其上，|就像|男子|和那匹马。|我说:|无限期|它是|每个|名词|已使用|非|用于指定|一|与其他比本身|从|其中|单数|其将性别，|而是|比做正确|其泛化|upon|每个|一|upon|方式|替换，|就像|(一个人)|并且|(女);|然后如果|第一|让正确|其泛化|upon|一位男性|成人/全年龄/成熟|从|儿子/部落|亚当的|和第二个|让正确|其泛化|upon|每个|女士|成人/全年龄/成熟|从|儿子/部落|亚当。|和标志|不确定|那|它是正确|因其|进入|在上面|(明确的粒子)|制作的影响|在它|确定|就像|(一个人)|然后当然它|让正确|进入|(明确的粒子)|在其上，|制作的影响|在它|明确;|然后你说:|(人)|和像这样:|一个男孩，|和一个女孩，|和一个男孩，|和一个女孩，|和一位科学家，|那么肯定你|你说:|那个男孩，|和那个女孩，|和那个男孩，|和那个女孩，|和科学家。|练习/演习|1-|地方|每个|名词|从|名词|给出了|in|三|句子|有意义，|所以| Yin|主格|in|一个人，|和宾格|in|第二，|和所有格|in|第三，|和描述|那|名词|in|每个|句子|与形容词|True|适当:|两名男子。|默罕默德。|麻雀。|老师。|一个女孩。|一朵花。|穆斯林。|你的父亲。|2-|地方|形容词|适当的|in|每个|地方|从|地方|空闲|in|例子|给出，|和地方|与元音符号:|(裁决)|学生|......|爱他|他的老师|() b|那个女孩|......|高兴|她的父母|() c|尼罗河|......|化肥|这片土地|() d|I|爱情|这本书|......|() e|我的国家|是埃及|......|() f|学生|......|服务|他们的国家|() g|花园|......|散步步行 /|() h|我见过|一个男人|......|所以我给了慈善机构/花|在他|() i|我住|in|一座房子|......|() j|如何|优秀/良好|房间|......|() k|通过与|我的兄弟|甘蔗/棒|......|() l|我给作为礼物|到|我的兄弟|一本书|......|() m|服装|......|服装|夏天的|3-|地方|被描述的词|适当的|in|每个|地方|从|地方|给出，|和地方|与元音符号:|(裁决)|......|努力工作|爱他|他的老师|() b|......|知识渊博|服务|他们的国家|() c|I|喜欢|......|有用|() d|......|值得信赖|通过与|一通|辉煌|() e|......|黑体|连根拔起|树木|() f|我拿起|......|绽放|() g|我看见|......|差|所以我给了慈善机构/花|关于她|() h|......|严重|非|是上承受得住|身体|() i|......|勤奋|服务|法律/伊斯兰教法|伊斯兰|() j|我受益|从|影响|......|以前早|() k|......|心爱|是我的本国|4-|查找|被描述的词|适当的|为每个|从|形容词|给出，|然后|使用|形容词|和被描述的词|一起|in|一个句子|有意义，|和地方|两个他们的结局|与元音符号:|巨大，|有礼貌，|高，|甜美新鲜|春暖花开，|聪明，|远，|慷慨，|诚实，|聪明，|有礼貌，|宽，|宽。|练习/演习|upon|拐点|活用|句子|给出:|这本书|是一个伴侣|令人愉快/令人愉快，|学生|努力工作|喜欢他|他的老师，|女孩子们|有礼貌|服务|他们的国家，|我喝了|从|水|鲜甜。|响应/答案|1-|这本书:|一门学科|主格|通过在开始，|和标志|它主格的|damma|表观|in|它的结局，|伴侣:|谓词|问题，|主格|通过在开始，|和标志|它主格的|damma|表观|in|它的结局，|令人愉快/令人愉快:|形容词|为伴，|形容词和|主格的|是主格，|和标志|它主格的|damma|表观|in|它的结束。|2-|学生:|一门学科|主格|通过在开始，|和标志|它主格的|damma|表观|in|它的结局，|努力工作:|形容词|对于学生来说，|形容词和|主格的|是主格，|和标志|它主格的|damma|表观|in|它的结局，|喜欢:|一个动词|现在时态|陈述语气|为其免费|从|虚拟语气|与命令，|和标志|它指示性的|damma|表观|in|它的结局，|和 haa:|代词|其他/第三人称的|采取行动|通过它，|结构|upon|damma|in|地方|宾格的|老师:|活动元素|喜欢|主格，|和标志|它主格的|damma|表观|in|它的结局，|和老师|附加所拥有，|和 haa|代词|其他/第三人称的|拥有/附加|到它，|结构|upon|damma|in|地方|所有格，|和这句话|从|动词|和其积极的元素|in|地方|主格的|谓词|主题|其中| Yin|学生，|和连接|介于|主题|和这句话|谓词的| Yin|代词|宾格|in|(喜欢他)。|3-|女孩:|一门学科|主格|通过在开始，|和标志|它主格的|damma|很明显，|和有礼貌:|形容词|女孩子们，|形容词和|主格的|是主格，|和标志|它主格的|damma|很明显，|服务:|一个动词|现在时态|结构|upon|苏坤|连接|中午与|女性的特质，|到中午|女性气质|是活跃的元素，|结构|upon|罚的骂|in|地方|主格的|国家:|采取行动|由它|为服务|宾格|和标志|其宾格的|罚的骂|很明显，|和国家|附加所拥有，|和他们:|代词|复数|女性气质|其他/三人|连接藏有|到它，|结构|upon|罚的骂|in|地方|所有格，|和这句话|从|动词|和活动元素|in|地方|主格的|谓词|主题|其中| Yin|女孩，|和连接|介于|主题|和这句话|谓词的|它是|中午|女性气质|in|(服务)。|4-|饮料:|一个动词|过去时态，|和 haa|代词|演讲者/第一人|活跃的元素，|结构|upon|damma|in|地方|宾格的|和从:|一个粒子|所有格，|结构|upon|苏坤|非|一个地方|为它|从|屈折变化，|水:|所有格|通过从，|和标志|其所有格的|kasra|很明显，|和所有格介词|这个词使所有格|有关|由饮料，|鲜甜:|形容词|为水，|形容词和|所有格的|是所有格，|和标志|其所有格的|kasra|表观|in|它的结束。|问题|upon|什么|来之前|此培训完成后，受众能够做些什么?| Yin|形容词吗?|进入|几个|部件|划分|形容词吗?|此培训完成后，受众能够做些什么?| Yin|形容词|真的吗?|此培训完成后，受众能够做些什么?| Yin|形容词|偶尔的吗?|此培训完成后，受众能够做些什么?|的|事情|其中|追随|在它|形容词|True|被描述的词吗?|此培训完成后，受众能够做些什么?|其中|如下|形容词|偶尔|in|男子气概|和女性吗?|此培训完成后，受众能够做些什么?| Yin|确定吗?|此培训完成后，受众能够做些什么?| Yin|代词?|此培训完成后，受众能够做些什么?| Yin|专有名词吗?|此培训完成后，受众能够做些什么?| Yin|名词|指向/示范吗?|此培训完成后，受众能够做些什么?| Yin|名词|关系代词?|生成|为每个|从|代词，|专有名词，|名词|指向/论证、|和名词|关系代词|-|三|示例|in|一个句子|有意义。
GreatMasterpiece58=颗粒|结合|它说:|(章|结合)|和颗粒|结合|十年|和他们是:|waw /，|和美国联邦航空局/和/所以/那时，|和那时/下一步，|或，|或，|或者，|但是，|而不是，|但是，|直到|in|某些|地方。|我说:|为连词|两层含义:|第一|语言|和其他|术语。|对于|它的意思|语言|然后是:|倾角/喜欢/附件，|你说:|以怜悯|任何人|upon|任何人|以怜悯|与喜欢，|引用|它|有之前倾向的喜好|到它|和富有同情心的同情|身上。|和|连词|in|术语|然后它是|两个部分:|第一:|结合/同位语|实地调查，|和第二个:|连词|协调。|然后为|结合/同位语|实地调查|然后它是|(从动件|惰性/静态|已显示|其追随者|in|确定性|具体来说|为它|in|不是确定性)|然后示例|结合/同位语的|实地调查|in|确定|(你来到我身边|默罕默德|你的父亲)|然后是你的父亲:|结合/同位语|实地调查|upon|默罕默德，|和每两个|明确，|和第二个|in|该示例|使清楚/显示|第一，|和示例|in|无限期|它说:|最高|(从|水|festering)(14:16)|然后溃烂|结合/同位语|实地调查|upon|水，|和每两个|无限期，|和第二个|in|该示例|指定|第一次。|和|连词|协调|然后它是|(从动件|其中|在中间|它之间|和之间|其中一项是跟随/词如下|一|粒子的|结合)|和这些|颗粒|他们是:|1-|Waw /，|它是|为完全|加入;|所以它加入|由它|两个连续的/以下，|就像:|(来了|默罕默德|和阿里)|If|was|正在加入|在一起，|和加入|与它|在之前|upon|延迟，|就像:|(来了|阿里|和马哈茂德)|If|was|正在加入|马哈茂德|项|upon|正在加入|阿里，|和加入|与它|延迟|upon|在之前，|就像:|(来了|阿里|和默罕默德)|If|was|正在加入|默罕默德|被延迟的|从|正在加入|阿里。|2-|Fah/所以/那时，|它是|继承安排|和以下/追求，|和意义|继承: 安排的|那|第二|之后|第一，|和意义|以下/追求:|它|它追求/如下|与不|延迟，|就像:|(到达|马兵|然后士兵)|If|was|正在加入|马兵|项|而不是|没有|介于|到来|两个缔约方|延迟。|3-|然后，|它是|继承安排|带有|偷懒/安排，|和意义|继承/安排|当然|之前，|和意义|懒散的/安排:|那|介于|第一|和第二个|是一个延迟，|就像:|(发送|真主|Moses|然后|耶稣|然后|默罕默德|在他们身上|称呼|与和平)。|4-|或，|它是|选择|或者|允许，|与差异|两者之间|那|选择|非|不允许/允许|与它|所有，|和可容许性|不允许|与它|所有;|然后示例|选择|(嫁给|后腿|或者|她的妹妹)|和示例|可容许性|(研究|教法法学|或者|阿拉伯语语法)|然后当然|你有|从|伊斯兰法|校样|upon|它|非|被允许的|一起|介于|后腿|和她的妹妹|与婚姻，|而不是|疑问|in|它|被允许的|一起|介于|教法法学|和阿拉伯语语法|在研究中。|5-|或，|它是|为请求|规范|之后|哈姆扎|质疑|就像:|(你学的吗|教法法学|或者|阿拉伯语语法吗?)。|6-|或者，|与条件|那|它位于之前|与这样的事情，|它是|类似|(或者)|in|这两个意思|就像|它说:|最高:|(然后牢固地束缚|债券|任一|帮个忙/迫使他们通过设置他们自由|此后|或者|采取 ransom)(47:4)，|和一样:|(嫁给|任一|后腿|或者|她的妹妹)。|7-|但是，|它是|信号/醒目/杰出，|和意义|它使|什么|在它之前是|in|裁决|什么是沉默/不回答|关于它，|就像:|(不|来了|默罕默德|but|巴克尔)|和所需|为契合|与它|两个条件;|第一:|那| Yin|紧接着是它的联体字|与它|一类奇异|非|一个句子，|和第二次:|那不|先于|提问的粒子。|8-|不，|它是|否定|这其中|在它之后是|相同或自我|执政的|其中|建立/确认|为此，|在它之前|就像:|(来了|巴克尔|非|哈立德)。|9-|但是，|它是|引用|upon|审批|信息|那|在它之前是|并建立/确认|它的对面|为此，|在它之后是|就像:|(不|我爱|那些懒惰的人|but|勤劳的工人 / 那些勤奋的人)|和所需|那|它前面|否定|或者|禁止，|和那| Yin|为以下/联体一词|与它|奇异，|而那不是|它前面|waw / 和。|10-|直到，|它是|为逐步/先进性|和目标/目的/目的，|和逐渐/先进性:|它是|是指|upon|传球/流逝|信息|一件事|然后/后另一件事，|就像:|(模具|人员|平|先知)。|谈|(直到)|正在启动|其他比|结膜，|If|was|什么|在它之后是|一个句子，|就像:|(来了|我们的朋友|平|哈立德|出席)|和谈|所有格|就像|它说:|最高:|(直到|休息时间产生|dawn)(97:5)|并为此|说过|作者|(和直到|in|某些|地方)。
GreatMasterpiece59=这项裁决|粒子的|结合|它说:|然后如果|被连体|upon|主格案例/指示心情|这将是主格案例/指示心情，|或者|upon|宾格案件语气|它将是宾格的案例/虚拟语气，|或者|upon|所有格|这将是所有格，|或者|upon|命令的心情|它将命令的心情，|你说:|(站在|宰|和 Amr，|我看见|宰|和 Amr，|和我通过|由扎伊|和 Amr，|与扎伊|没有|柜|也没有|坐)。|我说:|这些|颗粒|十|闭合|什么|是在他们以后|关注我的人|为此，|在他们面前的是|in|其执政|拐点，|然后如果|was|被跟踪的联体字|主格|was|从动件/连体|主格，|就像:|(遇见我|默罕默德|和哈立德)|然后哈立德:|皮带机|upon|默罕默德，|和乙肝|upon|主格|是主格，|和标志|它主格的|是 damma|很明显，|如果|was|这个词被人跟踪|宾格|was|从动件|宾格|就像:|(我见过|默罕默德|和哈立德)|然后哈立德:|皮带机|upon|默罕默德，|和乙肝|upon|宾格|是宾格|和标志|其宾格的|是罚的骂|很明显，|如果|was|这个词被人跟踪|所有格|was|从动件|所有格|它的示例中，|就像:|(我通过|由穆罕默德|和哈立德)|然后哈立德|皮带机|upon|默罕默德，|和乙肝|upon|所有格|是所有格，|和标志|其所有格的|kasra|很明显，|如果|was|这个词被人跟踪|命令的心情|was|从动件|命令的心情|此外，|就像:|(没有|参加|哈立德|或者|发送|信使号)|然后发送:|皮带机|upon|参加，|和乙肝|upon|命令的心情|是命令的心情，|和标志|其命令的|苏坤。|从|这些|示例|你知道的|那|名词|皮带机/附加|upon|名词，|和那|动词|皮带机/附加|upon|动词。|练习/演习|1-|付诸表决|皮带机|适当的|之后|粒子|结合|提到|in|例子|给出:|(裁决)|非|我买了|一本书|but|......|() b|非|我吃了|一个苹果|but|......|() c|生成|我的兄弟|一座房子|并且|......|() d|已参加|学生|然后|......|() e|我走了|这一天|星期四的|并且|......|() f|向左|那些|与研究所|直到连|......|() g|陪|那些人都好|非|......|() h|非|我参观了|我的兄弟|but|......|2-|付诸表决|皮带机|在上面|适当的|in|位置|空闲|从|例子|给出:|(裁决)|吃饭|从|水果|......|非|生/绿色|() b|仍然是|由你|你的父亲|......|或者|一些|天|() c|非|我读过|这本书|......|but|其中一些是|() d|非|我看见|......|but|他代表/监工|() e|排列|......|和你的工具或手段|() f|我一路向|到|......|然后到亚历山德里亚|() g|让我吃惊|......|非|他的演讲/语录|() h|这两个|你喜欢吗|......|或者|夏天。|3-|生成|每个|Word|从|单词|给出了|in|两句话，|所以| Yin|in|两个之一|皮带机|中和|第二|皮带机|它:|学者，|葡萄，|宫殿，|开罗，|他旅行，|他吃了，|勤奋的工人，|虔诚，|Ahmad，|欧麦尔|父亲|· 贝克尔的|阅读，|他写道。|练习/演习|upon|拐点|活用|句子|给出:|非|我看见|默罕默德|but|他代表/工头，|来拜访我们|你的兄弟|和他的朋友，|我的兄弟|吃|和饮料|好多。|答案/响应|1-|不是:|粒子|否定，|结构|upon|苏坤|非|一个地方|为它|从|屈折变化，|锯|从|我看见:|一个动词|过去时态|结构|upon|罚的骂|应该|upon|它的结局|防止|从|其明显|函数|这个地方|与苏坤。|及 taa|代词|演讲者/第一人|活跃的元素，|结构|upon|damma|in|地方|主格。|默罕默德:|采取行动|由它|宾格|和标志|其宾格的|罚的骂|很明显，|但:|一个粒子|结合，|代表/监督:|皮带机|upon|默罕默德，|和乙肝|upon|宾格|是宾格|和标志|其宾格的|罚的骂|很明显，|和代表/监督|附加/拥有|和 haa|代词|其他/第三人的|连接藏有|到它，|结构|upon|damma|in|地方|所有格。|2-|访问过的:|一个动词|过去时态|结构|upon|罚的骂|非|一个地方|为它|从|屈折变化，|和我们:|采取行动|由它|结构|upon|苏坤|in|地方|宾格的|哥哥:|活动元素|主格，|和标志|它主格的|waw|更换|从|damma|因为它|是从|名词|五、|和兄弟|附加/拥有|和 kaf|代词|处理/二人|连接藏有|到它|结构|upon|罚的骂|in|地方|所有格，|和 waw|粒子|结合，|和朋友|皮带机|upon|哥哥，|和乙肝|upon|主格|是主格，|和标志|它主格的|damma|很明显，|和朋友:|附加/拥有|和 haa|代词|其他/第三人的|连接藏有|到它，|结构|upon|damma|in|地方|所有格。|3-|Brother|从|我的兄弟:|一门学科|主格|开始，|和标志|它主格的|damma|应该|upon|它的结局|防止|从|其明显|函数|这个地方|与元音迹象|适当情况下，|和兄弟|附加/拥有|和严|演讲者/第一人|连接藏有|到它，|结构|upon|苏坤|in|地方|所有格，|他吃:|一个动词|现在时态|陈述语气|为其免费|从|虚拟语气|与命令，|和标志|它主格的|damma|很明显，|和活动元素|代词|隐藏|在它|允许|其所谓| Yin|返回|upon|我的兄弟，|和这句话|从|动词|和活动元素|in|地方|主格的|谓词|问题，|和连接|介于|这句话|谓词的|和主题| Yin|代词|隐藏|in|(他吃)|和 waw|粒子|结合|他喝的|一个动词|现在时态|皮带机|upon|他吃了，|和乙肝|upon|陈述语气|是陈述语气，|和标志|它指示性的|damma|很明显，|好多：|采取行动|由它|因为他吃，|宾格|和标志|其宾格的|罚的骂|明显。|问题|此培训完成后，受众能够做些什么?| Yin|结合吗?|进入|几个|部件|划分|结合吗?|此培训完成后，受众能够做些什么?| Yin|连词|实地调查的吗?|生成|为契合|实地调查|两个例子。|此培训完成后，受众能够做些什么?| Yin|连词|协调吗?|此培训完成后，受众能够做些什么?|意思是|waw 的 / 和?|此培训完成后，受众能够做些什么?|是的意义|(或者)?|此培训完成后，受众能够做些什么?|是的意义|(是)?|此培训完成后，受众能够做些什么?|其中|必需|为契合|与但吗?|此培训完成后，受众能够做些什么?|其中|必需|为契合|带有|(但) 吗?|哪些东西|股票|皮带机|和乙肝|在上面吗?|活用|句子|给出了|和是指|皮带机|和乙肝|在上面|与仪器|结合|(|而且我们在带走了|孩子们|以色列的|海|嗓门糙那时/追赶他们|法老|和他的 troops)(10:90)|(所以给|相对|亲密的|他的权利|和穷人|越走越远|方式|)(30:38)|(美化|真主确|什么|在|诸天|和地球||他是|全能的上帝|Wise)(57:1)|(和肯定|从|人民|这本书的|那些是谁|相信|在安拉|和什么|揭示了|给你|和什么|揭示了|对 them)(3:199)|(和很快|会给你|你的主|那，你会高兴的|() 5|没有|他找到你|一个孤儿|然后庇护你|() 6|还是找到了你|迷了路|然后指导你|() 7|还是找到了你|有需要的人的需要|然后浓缩/提供的 you)(93:5-8)|(然后|地狱之火|把他成|() 31|然后|in|链|它的长度|七十|肘|然后绑定/插入 him)(69:31-32)。
GreatMasterpiece60=强化重点/并列，|和它的类型，|和其裁决|它说:|(章|强化重点/同位语) 的|重点:|(一个追随者|为强调明确的词|in|它主格|和其宾格|和其所有格|和其确定性)。|我说:|重点|-|它是说|重点|-|它的意思|in|语言:|加强所加剧，|你说:|(我已确认|东西)|和你说:|(我已确认)|此外:|If|加强它。|它是|in|术语|语法|两种，|第一:|强化重点 /|口头，|和第二个:|强化重点 /|意义。|对于|强化重点 /|语言:|然后是|与重复|表达/发音|和其重复|由本身|或者|与它的同义词，|是否|was|一个名词|就像|(来了|默罕默德|默罕默德)|或者|was|一个动词|就像|(来了|来了|默罕默德)|或者|was|一个粒子|就像|(是的|是|来了|默罕默德)|就像|(来了|出席|父亲|巴克尔) 的|并且|(是的|是|来了|默罕默德)。|和|强化重点 /|意义|然后是:|(从动件|其中|引发|概率|缺席 mindedness/疏忽/遗忘的|或者|扩展/夸大/夸大|in|以下)|和澄清|此|那你|If|说:|(来了|领导)|可能性|那你|心不在焉|或者|扩大|in|演讲，|和那|你的意图|是的到来|使者|领袖，|然后如果|你说:|(来了|领袖|他自己)|或者|你说:|(来了|领袖|他自己)|他养了|可能性|并建立了/确认它|带有|侦听器|那你|没有|打算/说/提|除了|到来|领袖|他自己。|和执政的|这|关注者|它|同意|这个词被人跟踪|in|其拐点|upon|意义|它|If|was|这个词被人跟踪|主格|was|从动件|主格|此外，|就像|(出席|哈立德|他自己)|如果|was|这个词被人跟踪|宾格|was|从动件|宾格|喜欢它，|就像:|(我记得|古兰经 》|所有的它 / 整个)|如果|was|这个词被人跟踪|所有格|was|从动件|所有格|诸如此类|就像:|(I 反映所设想|打开|这本书|所有的它 / 整个)|和如下|还|in|其确定性，|像什么|你看见|in|例子|所有这些。
GreatMasterpiece61=表达式|强化重点 /|意义|它说:|和是|与表达式|特定，|和他们是:|自我，|和自我/相同，|和每个/一切，|和整个/整体/一切，|和追随者|复数/整个/整体/一切，|和他们是:|所有/一共/整体/全缘，|和所有/一共/整体/全缘，|和所有/一共/整体/全缘，|你说:|站在|宰|自己，|我看见|人民|所有的人，|与我擦肩而过|人民|所有。|我说:|为强化重点 /|通过的意义|有的表达式|特定|由已知|语法学家|谁|追随|这次演讲|阿拉伯人的|和从|这些|表达式:|自我|和同一/自我，|并且必须|那|高度重视|每个|一|从|这两个|到|代词|返回|upon|确切的消息，被强调|-|与罚的骂|kaf 的|-|然后如果|was|确切的消息，被强调|单数|was|代词|奇异，|和表达|重点|单数|此外，|你说:|(来了|阿里|他自己)，|并且|(出席|巴克尔|他自己)|如果|was|确切的消息，被强调|复数|was|代词|it|复数|与表达|重点|复数|此外，|你说:|(来了|男子|他们自己)，|并且|(出席|作家|他们自己)，|如果|was|确切的消息，被强调|双;|然后最正确|那| Yin|代词|双，|与表达|重点|复数，|你说:|(出席|两个男人|他们两个/自己)|并且|(来了|这两位作家|他们两个/自己)。|从|表达式|重点|(所有/每一)，|和它的同类|(整个/整体/一切)|它是一个条件|在两个和两个|连接的|每个|从这两个|到|代词|关注|确切消息，被强调的|就像:|(来了|军队|整个/所有的它)|并且|(出席|男子|一共)。|从|表达式|(整个/整体/一切)|而不是|强调|与此|表达式|著名主导方式|除了|之后|表达式|(每个/一切)|和从|著名主要方式|它说:|最高|(然后伏|天使|所有这些|together)(15:30)|和从|其他比|著名主要方式|这句话|Raajiz:|然后|我会保持|哭泣|为永恒|全部|也许|有必要|到|增加/扩展|加强/强化，|令人惊讶|之后|整个/整体/一切|与表达式|其他，|和他们是:|(所有/一共/整体/整个)|并且|(所有/一共/整体/整个)|并且|(所有/一共/整体/整个)，|和这些|表达式|非|强调|与他们|独立/靠自己，|就像:|(来了|人民|全部|一起|所有这些|一共)|和阿拉|知道。|练习/演习|upon|拐点|活用|句子|给出:|我读过|这本书|所有的它。|来拜访我们|部长|他自己。|迎接我的|upon|你的兄弟|自己在人/个人。|来了|男子|军队的|一共。|1-|已阅读:|一个动词|过去时态，|结构|upon|罚的骂|应该|upon|它的结局|防止|从|其明显|函数|地方|与苏坤|参展商|为排斥|不喜欢|继承|四|元音的迹象|在什么| Yin|像这个词|一个人，|及 taa|代词|演讲者/第一人|活跃的元素，|结构|upon|damma|in|地方|主格的|和这本书:|采取行动|由它|宾格|和标志|其宾格的|罚的骂|很明显，|和所有:|强调|这本书，|并强调|宾格的|是宾格|和标志|其宾格的|罚的骂|很明显，|和所有|连接藏有|和 haa|代词|其他/第三人的|附加/拥有|到它，|结构|upon|damma|in|地方|所有格。|2-|访问过的:|一个动词|过去时态，|结构|upon|罚的骂|非|一个地方|为它|从|屈折变化，|我们:|采取行动|由它|结构|upon|苏坤|in|地方|宾格的|和主任:|活动元素|访问|主格，|和标志|它主格的|damma|表观|in|它的结局，|和自我:|强调|为主任，|和重点|主格的|是主格，|和标志|如果其主格|damma|很明显，|和自我|连接藏有|和 haa|代词|其他/第三人的|连接藏有|到它，|结构|upon|damma|in|地方|所有格。|3-|迎接我:|一个动词|和积极的元素，|后:|一个粒子|所有格的|结构|upon|苏坤|非|一个地方|为它|从 /|屈折变化，|哥哥:|所有格|通过后，|和标志|其所有格的|是啊|更换|从|kasra|因为它|是从|名词|五、|和兄弟|附加/拥有|和 kaf|代词|处理/二人|连接藏有|到它，|结构|upon|罚的骂|in|地方|所有格，|自我的人/个人:|强调|为兄弟，|和重点|所有格的|是所有格，|和标志|其所有格的|kasra|很明显，|和自我的人/个人|附加/拥有|和 haa|代词|其他/第三人的|连接藏有|到它，|结构|upon|kasra|in|地方|所有格。|4-|来了:|一个动词|过去时态|结构|upon|罚的骂|非|一个地方|为它|从|屈折变化，|男女:|活动元素|主格，|和标志|它主格的|damma|表观|in|它的结局，|男女|附加所拥有，|和军队:|连接藏有|到它|所有格，|和标志|其所有格的|kasra|很明显，|和所有:|强调|男人，|和重点|主格的|是主格，|和标志|它主格的|damma|很明显，|和所有|附加所拥有，|和他们:|代词|复数|其他/第三人的|连接藏有|到它，|结构|upon|苏坤|in|地方|所有格，|一共:|强调|第二个|主格，|和标志|它主格的|waw|更换|对于|damma|因为它|是复数|男性|声音。|问题|此培训完成后，受众能够做些什么?| Yin|重点吗?|进入|几个|部件|划分|重点吗?|生成|三|示例|不同|为重点|口头，|什么| Yin|表达式|其中|已使用|in|强调|抽象的吗?|此培训完成后，受众能够做些什么?|其中|必需|为重点|与自我|与相同或自我吗?|此培训完成后，受众能够做些什么?|其中|必需|为重点|与每个/一切|和整个/整体/一切吗?|是|已使用|(一共)|in|强调|其他比|之前|由全/每一吗?|活用|例子|给出:|其中|人员|你接受|他的行为/属性|他自己吗?|学生|所有这些|是成功的|我看见|阿里|自己的人，|我参观了|两个老男人/shaykhs|他们两个。
GreatMasterpiece62=替代|和其裁决|它说:|当|我替换|一个名词|从|一个名词|或者|一个动词|从|一个动词|它遵循|in|全部|它的拐点。|我说:|替代|它的意思|in|语言:|替代交换|你说:|我替换用代替|这/像这样|与那/像这样，|和我替换用代替|这/像这样|从|那/像这样，|你想要|那你|替代它|为它。|它是|in|术语|语法|(从动件|目的|执政的|无|手段/中介/介质)。|和其裁决|它|如下|取代|从它|in|其拐点|upon|意义|它|If|was|取代|从它|主格|was|替代|主格，|就像:|(出席|亚伯拉罕 ·|你的父亲)|如果|was|取代|从它|宾格|was|替代|宾格|就像:|(我见过|亚伯拉罕 ·|他的弟弟)|如果|was|取代|从它|所有格|was|替代|所有格，|就像:|(我喜欢/让我吃惊|字符方式|穆罕默德的|你的叔叔)|如果|was|取代|从它|命令的心情|was|替代|命令的心情，|就像:|(无论是谁|谢谢你|他的主|prostrates|给他|将成功)。|种类|替代的|它说:|它是|upon|四|部件:|替代/更换|东西|从|东西，|和替代|某些部分|从|整体，|和替代|安全壳/包容性|和替代|不正确/错误，|就像|你说:|(站在|宰|你的兄弟，|我就吃了|一卷/条面包|第三，|和给我带来好处|扎伊德|他的知识，|我看见|扎伊德|马)，|你想要|那|你说的|那匹马|然后以犯错误以为|然后代|扎伊德|从它。|我说:|替代|upon|四|种类:|那种|第一:|代/更换|整个|从|整体，|它被称为|替代品|完成/绝对，|和它的一般规则:|那| Yin|替代|一样|取代的|从它，|就像:|(拜访了我|默罕默德|你的叔叔)。|那种|第二:|替代|某些部分|从|整体，|和它的一般规则:|那| Yin|替代|部分|从|取代|为它，|是否|它是|更少|从|剩下的人|或者|等于|到它|或者|更多|比它，|就像:|(我记得|古兰经 》|它的第三个)|或者|(它的一半)|或者|(三分之二的它)|和基本|in|此|种类|那|连接的|到|代词|返回|到|取代|从它，|像什么|你看见。|那种|第三:|替代|安全壳/包容性|和它的一般规则:|那| Yin|介于|替代|和取代|从它|连接|无|整个完整|或部分/部分，|和基本|在它|附件/藏建设|替代的|到|代词|返回|到|取代|为它|此外，|就像:|(我喜欢/让我吃惊|那个女孩|她的发言)|并且|(给我带来好处|这位教授|好|他的性格)。|那种|第四:|替代|错误/不正确，|与此|种类|upon|三|规则:|1-|替代|清除，|和它的一般规则:|那|你想说|东西|然后你说，|然后|它似乎变得清晰|给你|那|要将其更改为|什么是更好|比它|然后你改变|到它，|和那|像什么|If|你说:|(这件事|女孩|是一个满月)|然后|你说|之后|:|(太阳)。|2-|替代|健忘/心不在焉，|和它的一般规则:|那|你构建|你的话语|in|第一|upon|感知你的怀疑，|然后|你知道的|其不正确|所以你会改变|从它，|像什么|If|你看见|一个图的形状/人|从|远|然后它变得清晰|一个人|然后你说:|(我见过|一个人)|然后|附近的|从你|然后你发现它|(马)|然后你说:|(马)。|3-|替代|错误/不正确，|和它的一般规则:|那|你打算|单词|然后说之前|你的舌头|到|其他比它|前后|念念说 /|你改变|到|什么|你想要或意欲|第一，|就像:|(我见过|默罕默德|那匹马)。|演习/练习|1-|歧视|种类|替代的|contained|in|句子|给出:|让我快乐|字符|穆罕默德的|我们的邻居，|我看见|这艘船|其帆，|给我带来好消息|我的妹妹|法蒂玛|这即将来临的|我的父亲，|让我吃惊|花园里|它的花朵，|把我吓坏了|狮子|它的吼声，|我喝了|水|亲爱，|我来了|到|这房子|这座清真寺，|我骑|火车|那匹马。|2-|付诸表决|in|每个|地方|从|地方|空闲|替代|适当情况下，|并将其放置|与元音符号:|(裁决)|我感到很荣幸|你的兄弟|......|和旧的|() b|来了|朝圣者|......|和他们走的人|() c|尊重|全部|家人的人|......|和他们的女人|() d|美国|整个|国家|......|和它的老人|3-|付诸表决|in|每个|地方|从|地方|空闲|替代|完成/绝对/相对应|适当的|和地方|与元音符号:|(裁决)|was|指挥官|信徒的|......|一个典范|司法/公平的|() b|被称为|哈里发/继任者|先知锯|......|善良/柔软|心|() c|是快乐|法官|......|那|是推进/上升|他民族。|() d|旅行|我的兄弟|......|到|亚历山德里亚。|4-|付诸表决|in|每个|地方|从|地方|空闲|替代|安全壳/包容性|适当情况下，|和一般规律|与元音符号:|(裁决)|高兴/很高兴我|花园里|你的房子|......|() b|让我吃惊|老师|......|() c|我打了我的信心|和你的朋友|......|() d|我很高兴|与此|学生|......|() e|我爱|默罕默德|......|() f|我很高兴|哈立德|......|5-|付诸表决|in|每个|地方|从|地方|空闲|取代|为它|适当情况下，|并将其放置|与元音的迹象，|然后|请参阅|那种|替换:|(裁决)|给我带来好处|......|他的知识|() b|我买了|......|它的一半|() c|拜访了我|......|默罕默德|() d|If|......|你的父亲|你尊重他|然后你就会成功|() e|给我我喜悦/高兴 / 我高兴|......|它的花朵。|() f|我踏上|一段旅程|long|我骑|关于它|......|一辆车|问题|此培训完成后，受众能够做些什么?| Yin|替代吗?|在什么|如下|替代|取代|为它吗?|进入|几个|部件|划分|替代吗?|此培训完成后，受众能够做些什么?|其中|必需|in|替代|某些部分|和替代|安全壳/包容性?|此培训完成后，受众能够做些什么?|是的一般规则|替代的|整体?|此培训完成后，受众能够做些什么?|是的一般规则|替代的|某些部分?|此培训完成后，受众能够做些什么?|是的一般规则|替代的|安全壳/包容性?|此培训完成后，受众能够做些什么?| Yin|替代|错误/不正确吗?|和什么|它的部分?|和什么|是的一般规则|所有的|部分吗?|活用|例子|给出:|信使|真主|默罕默德|印章|之明证，|无法无法|阿拉伯人|从|生产|与古兰经 》|十|诗句|从它，|让我吃惊|天空|其明星。
GreatMasterpiece63=盘点|接动名词做宾语，|和他们一样|它说:|(宾格|名词)|接动名词做宾语|五|十、|和他们是:|所作所为后|通过它，|和不定式|和副词|时间，|和副词|地方，|和条件，|和规格，|和除外/排除在外，|和名词|不，|和呼格的名词，|并采取行动 / 对象|对于|为了它，|并采取行动 / 对象|伴随着它，|和谓词|动词，是的|和它的姐妹，|和名词|当然宾/粒子的|和它的姐妹，|和追随者|为宾格|和他们是|四|事情:|形容词，|和一起，|并强调，|和替代。|我说:|让宾格|名词|If|位于|in|位置|从|五|十|职位。|我们将讨论|upon|每个|一|从|这些|位置|in|一章|指定为它，|upon|手法方法|其中|我们曾之前/踏上它|in|这一章|nominatives，|我们让|为它|此处|示例|与目的|解释|和澄清。|1-|它|位于|采取行动|通过它，|就像|(诺亚)|从|它说:|最高:|(事实上|我们发送|Noah)(71:1)。|2-|它|位于|不定式|就像|(幸福)|从|你说:|(是快乐的|默罕默德|幸福)。|3-|它| Yin|副词|地方|或者|副词|时间;|然后第一次|就像|(前面的|老师)|从|你说:|(我坐|前面|老师)|和第二个|就像|(一天|星期四)|从|你说:|(出席|我的父亲|这一天|星期四)。|4-|它|位于|条件下，|就像|(觉得有趣)|从|它说:|最高:|(于是他 (所罗门) 笑了|amused)(27:19)。|5-|它|位于|一种规范，|就像|(汗)|从|你说:|(被打湿了|扎伊德|汗)。|6-|它|位于|例外/排除在外，|就像|(穆罕默德)|从|你说:|(出席|人民|除了|默罕默德)。|7-|它|位于|一个名词|为 laa|否定，|就像|(学生|知识)|从|你说:|(没有|学生|知识|是该受责备/虞)。|8-|它|位于|呼格的名词，|就像|(信使|真主)|从|你说:|(O 信使|真主)。|9-|它|位于|一个对象|为了它，|就像|(作为纪律处分)|从|你说:|(严厉对待|这位教授|瞳孔|作为纪律处分)。|10-|它|位于|一个对象|伴随着它，|就像|(带灯)|从|你说:|(我已修订|与灯)。|11-|它|位于|谓词|动词是|或者|一|它的姐妹|或者|一个名词|当然宾/粒子|或者|一|它的姐妹;|然后第一次|就像|(朋友)|从|你说:|(是|亚伯拉罕 ·|一位朋友|到阿里)|和第二个|就像|(穆罕默德)|从|你说:|(我希望|默罕默德|来拜访我们)|12-|它|位于|形容词|为宾格|就像|(尊敬)|从|你说:|(我朋友/成为了朋友|默罕默德|尊敬)。|13-|它|位于|皮带机|upon|宾格|就像|(巴克尔)|从|你说:|(击中/击/击败|哈立德|Amr|和巴克尔)。|14-|它|位于|重点|为宾格|就像|(全部)|从|你说:|(我记得|古兰经 》|所有的它)。|15-|它|位于|替代|从|宾格|就像|(它的一半)|从|它说:|最高:|(站在守夜|在黑夜|除了|一点儿|() 2|它的一半|或者|减少|从它|little)(73:2-3)。
GreatMasterpiece64=对象/行事|由它|它说:|(章|对象/行事|由它)|和它是:|名词，|宾格|其中|位于|在上面|动词，|就像|你说:|我打节拍击中|扎伊德，|我骑|那匹马。|我说:|对象/行事|由它|根据被叫|到由|语法学家|upon|这其中|结合|三|事情:|第一，|那| Yin|名词，|然后不| Yin|对象/行事|由它|一个动词|或者|一个粒子。|和第二次:|那| Yin|宾格;|然后不| Yin|对象/行事|由它|主格|而不是|所有格。|和第三:|那| Yin|动词|活动元素的|当然|发生/发生/正在发生|在其上，|和的意思|由其发生/发生|在上面|其附|有了它，|是否|was|那|从|外的方式|确认，|就像|(我理解|这一课)|或者|was|upon|外的方式|否定，|就像|(没有|了解|课)。|种类|对象/行事|由它|它说:|它是|两个部分:|明显的/名词，|并暗示/代词;|然后明显|非|开始|它的提及，|和默示|两个部分:|附加，|和失散，|金及附加|是两个|十、|和他们是:|他命中/击败我，|和他命中/击败我们，|和他命中/击败你阳刚，|和他命中/击败你女性，|和他命中/击败你们两个，|和他命中/击败你所有男性，|和他命中/击败你所有女性，|和他命中/击败他，|和他命中/击败她，|和他命中/击败他们两个，|和他命中/击败他们阳刚，|和他命中/击败他们女性。|和失散|是两个|十、|和他们是:|我，|而我们，|和你阳刚，|和你的女性，|还有你们两个，|和你所有男性，|和你所有女性，|和他，|和她，|和他们两个，|和他们的男子气概，|和他们的女性。|我说:|划分|对象/行事|由它|到|两个部分:|第一|很明显，|和第二个|隐含。|肯定|你知道的|那|表观|这其中|是指|upon|它的意思|无|需要|到|连接|一位发言者的/第一人|或者|收信人/第二人|或者|另一/三人，|和那|暗示|这其中|非|是指|upon|它的意思|除了|与连接|从|这些|连接|三;|然后示例|明显|(命中/击败|默罕默德|巴克尔)|并且|(点击率/节拍|哈立德|) Amr|并且|(拿起|伊斯梅尔|一朵花)|并且|(拿|伊斯梅尔|一朵花)。|并且划分|暗示|宾格|into|两个部分:|第一|附加，|和第二个|分隔。|对于|所附|然后是:|这其中|非|开始|与它|这次演讲|而不是|是正确的|它是放会发生|之后|(除外)|in|所选内容。|和|分离|然后是:|这其中|开始|与它|这次演讲|和是正确的|它是放会发生|之后|(除外)|in|所选内容。|所附|二|十|表达式:|第一:|是啊，|它是|扬声器/第一人|一个人，|并且必须|那|分离|它之间|和之间|动词|中午与|被称为|中午|保护，|就像|(是对我百依百顺|默罕默德)|并且|(是对我百依百顺|巴克尔)|并且|(服从我|阿巴克尔)。|和第二个:|(我们)|它是|扬声器/第一人|小菊|他自己|或者|与他|别人比他，|就像|(服从我们|我们的太阳)。|和第三个:|kaf|与罚的骂|它是|为解决/二人|单数|男性，|就像|(怕你|你的儿子)。|和第四个:|kaf|与 kasra|它是|为解决/二人|单数|女性，|就像|(怕你|你的儿子)。|和第五个:|kaf|连接的|与它|米姆|和阿勒夫|它是|为双|每秒处理人|不受限制，|就像|(他担心你两个)。|而第六:|kaf|连接的|与它|米姆|独自一人，|它是|为复数形式|男子气概|每秒处理的人，|就像|(他担心你所有男性)。|和第七个:|kaf|连接的|与它|中午|与 shadda，|它是|为复数形式|女性气质|每秒处理的人，|就像|(他担心你所有女性)。|和第八:|haa|与 damma，|它是|其他/三人|单数|男性，|就像|(他又怕他)。|和第九届:|haa|连接的|与它|阿勒夫|它是|其他/三人|单数|女性，|就像|(他担心她)。|和第十届:|haa|连接的|与它|米姆|和阿勒夫|它是|为双|其他/三人|不受限制，|就像|(他担心他们两个)。|和第一次|十:|haa|连接的|与它|米姆|独自一人，|它是|为复数|男子气概|其他/三人，|就像|(他担心他们男性)。|和第二个|十:|haa|连接的|与它|中午|与 shadda，|它是|为复数形式|女性气质|其他/三人，|就像|(他担心他们女性)。|并为分离:|二|十|表达式|此外，|和他们是|(对象代词干)|正在加入|与阎|扬声器/第一人|独自一人，|或者|(我们)|对赞美的人|自己，|或者|带有|别人比他，|或者|与 kaf|与罚的骂|为解决/二人|单数|男性，|或者|与 kaf|与 kasra|为解决/二人|单数|女性，|而不是|保守的秘密|在你身上|知道|休息/余数。|和正确|那|代词| Yin|(对象代词干)|和那|这其中|在它之后是|连接，贴，附属物|引用|upon|演讲者/第一人|或者|收信人/第二人|或者|缺席的一次、 三次人，|你说:|(我|服从|学生)|并且|(不|很听话|学生|除了|对我来说)|并从它|它说:|最高:|(你独自|我们崇拜|和你独处时|我们要求 help)(1:5)|它说:|崇高:|(他吩咐|那不|你崇拜|除了|Him)(12:40)。|演习/练习|1-|付诸表决|代词|分隔|适当的|in|每个|地方|从|地方|空闲|所以是|反对采取行动|有了它，|然后|请参阅|它的意思|之后|那|你放|与元音符号:|(裁决)|O|学生|......|正在等待|未来。|() b|O|女孩|......|期待|这个国家。|() c|O|神有意识|......|希望能够|虔诚。|() d|O|女孩|......|正在等待|你的父亲。|() e|O|信徒|......|将奖励|真主。|() f|当然|默罕默德|事实上|被延迟的|......|我等待着|长。|() g|这些|女孩|......|希望能够|虔诚。|() h|阿默罕默德|非|我等待着|除了|......|2-|付诸表决|每个|名词|从|名词|给出了|in|一个句子|有意义|所以| Yin|对象/采取行动|由它:|这本书，|树上，|这支笔，|这座山，|这匹马，|一双鞋，|窗户，|那所房子。|3-|更改|代词|给出了|into|代词|附加的|然后|闭合|每个|一|从它|对象/采取行动|由它|in|一个句子|有意义:|他们两个，|你所有男性，|我，|你所有的女性，|他，|你们两个，|我们。|4-|给|为每个|谓词|从|动词|给出了|活动元素|对象/采取行动|由它|有两个意义:|他读，|他看到，|他爬上了，|他骑着马，|他买了，|他居住，|他打开，|他杀了，|他的玫瑰/爬上。|5-|生成|六|句子，|和使|in|每个|句子|两个名词|从|名词|给出了|所以| Yin|一|两个名词|活动元素|和其他|对象/直接宾语|由它:|默罕默德，|这本书，|阿里，|这棵树，|亚伯拉罕，|那根绳子，|哈利勒|水，|Ahmad，|消息/论文，|· 贝克尔|这个问题。|6-|给|七|句子|有意义|所以| Yin|每个|句子|撰写/写/包括|从|一个动词|活动元素|对象/采取行动|通过它，|和是|对象/采取行动|由它|代词|分离，|与条件|那不|提到|代词|一|两次。|7-|给|七|句子|有意义|所以| Yin|每个|句子|撰写/写/包括|从|一个动词|活动元素|对象/采取行动|通过它，|和是|对象/采取行动|由它|代词|附加，|与条件|那| Yin|代词|in|每个|一|不同|对它的兄弟。|问题|此培训完成后，受众能够做些什么?| Yin|对象/行事|由它吗?|进入|几个|部件|划分|对象/行事|由它吗?|此培训完成后，受众能够做些什么?| Yin|明显的吗?|生成|三|示例|为对象/行事|由它|明显。|此培训完成后，受众能够做些什么?| Yin|暗示吗?|进入|几个|部件|划分|暗示吗?|此培训完成后，受众能够做些什么?| Yin|暗示|连接吗?|几个|表达式|暗示|连接的|其中|位于|对象/行事|由它吗?|此培训完成后，受众能够做些什么?| Yin|暗示|分开?|几个|表达式|暗示|分隔|其中|位于|对象/行事|由它吗?|此培训完成后，受众能够做些什么?|其中|必需|那|分隔|由它|介于|动词|和严|演讲者/第一人?|生成|完成|三|示例|暗示|连接的|位于|对象/采取行动|通过它，|与同三|示例|其他|暗示|分隔|位于|对象/采取行动|由它。|活用|例子|给出:|然后不|怕他们|和恐惧 Me(5:3)。|与崇拜|真主|而不是|您将相关联|与他|anything(4:36)。|它|是这本书|非|疑问||在它||指导|为虔诚|() 2|那些人|相信|在看不见的|并建立|祷告|和从什么|向他们提供了|他们 spend(2:2-3)。|他们会得到回报|对于|压迫|人|海侵/压迫|与宽恕|和|邪恶|人|罪的工价|与善良。
GreatMasterpiece65=动词不定式|它说:|(章|不定式) 的|动词不定式|它是:|名词，|宾格|其中|来自|第三个|in|共轭|动词，|就像:|他打了，|他打了，|打。|我说:|当然|知道|作者|动词不定式|它由|(其中|来自|第三个|in|共轭|及物动词)|和意义|那|是它|If|说过|给你|某人:|共轭|(他打)|例如，|那么肯定你|提及|过去时态|第一，|然后|来自|与目前的紧张，|然后|用不定式|所以你说:|他确实打了，|他打了，|打。|并不是|目的|此处|了解知道|不定式/名词|本身，|当然什么|目的|了解知道|对象|不受限制的/绝对/完成，|和它| Yin|不定式/名词，|它是|短语|从|(这其中|不是|信息/谓词|用什么|是指|upon|确认/强调|动词|或者|其种，|或者|它的数字)。|然后我们说:|(不是|谓词)|取出|为什么|was|谓词|从|动词不定式/词名词|就像|你说:|(你的理解|是一种理解|精确)。|和我们说:|(用什么|是指|......|等 / 等等)|意义|那|对象|绝对/完成|三|种类:|第一:|确认/强调|为其动词|就像|(我记得|这一课|记忆的心)，|和一样:|(我很高兴|对您的到来|快乐)。|和第二个:|澄清|这类型的|行动/动词，|就像:|(我爱|我的老师|像爱和爱|一个男孩|他的父亲)，|和一样:|(我站|这位教授|站立|有礼貌)。|和第三个:|澄清|数量计数|就像:|(我打|懒人|两次)，|和一样:|(我打了他|三|倍)。|种类|不定式/名词|绝对/完成|它说:|它是|两个部分:|发音/言语，|而语义/方面的意义，|然后如果|同意|它的发音|发音|其动词的|然后它是|发音/言语，|就像:|杀了他|杀戮/致命，|如果|同意|意义|其动词的|无|其送电|然后它是|语义/有关的意思，|就像:|我坐在|坐在上下，|和我站在|一个站/向上/高高的|和什么|是类似于|那。|我说:|划分|动词不定式|其中|让宾格|upon|它|是一个对象|完成/绝对|into|两个部分:|第部分|第一:|这其中|同意|动词|宾格|为它|in|其表达式，|与那| Yin|非独占|upon|它的字母，|中和|意义|还|与那| Yin|意义|目的|从|动词|它是|意义|目的|从|不定式，|和那|就像:|(我坐|坐/向下)，|并且|(我打败他|殴打吃力地)|并且|(去|去/第四)|和什么|是类似于|那。|和部分|第二:|什么|同意|动词|宾格|为它|in|它的意思，|而不是|它同意|in|它的字母，|与那| Yin|字母|不定式的|其他比|字母|动词，|和那|就像:|(我坐|坐/向下)|然后如果|意义|(坐)|它是|意义|坐，|那么就不是|字母|这个词的|一个人，|和喜欢|那|(我变得快乐|幸福与喜悦/快乐)|并且|(我打败他|一击)|并且|(我羞辱他|羞辱/令人尴尬的)，|并且|(我站|站起来/大)|和什么|是类似于|那，|和阿拉|光荣是他|和是崇高|最|而且他知道。|演习/练习|1-|生成|每个|谓词|从|动词|给出了|in|两个句子|有意义，|并给出|为每个|谓词|与它的不定式|宾格|upon|它|是一个对象|绝对/完成:|确认/重点|为操作的动词|有一次，|与指定|为它的种类|按流量预付费|其他:|他能记住。|他喝了。|他演奏。|他请求宽恕。|他卖掉。|他感动。|2-|生成|每个|名词|从|名词|给出了|一个对象|完成/绝对|in|一个句子|有意义:|要记住。|来玩|静静地。|出售|从必要性。|要走|快速。|要清醒|长。|对愤怒|狮子。|跳转|老虎。|进行了总结。|3-|付诸表决|一个对象|绝对/完成|适当的|in|每个|地方|从|地方|空闲|给出:|(裁决)|担心|阿里|......|() b|出现|满月|......|() c|爆发|这座火山|......|() d|离开|空闲的谈话嘲弄|......|() e|保持距离|在开玩笑|......|() f|水煮|烹饪的水壶/锅炉|......|() g|水浸|尼罗河的|......|() h|哭了|宝贝|......|问题|此培训完成后，受众能够做些什么?| Yin|不定式?|此培训完成后，受众能够做些什么?| Yin|对象|完成/绝对?|进入|几个|划分|对象|完成/绝对|从|侧面|什么|打算|从它吗?|进入|几个|部件|划分|对象|绝对/完成|从|条件|它等于|为其动词|或以其他方式吗?|生成|三|示例|对象|绝对/完成|确认/强调|其动词|闭合|三|示例|对象|绝对/完成|指定|对于那种|动词的|闭合|三|示例|对象|绝对/完成|指定|为数量计数|闭合|三|示例|为一个对象|绝对/完成|宾格|与动词|从|其表达式，|与同三|示例|为一个对象|绝对/完成|宾格|与动词|从|它的意思。
GreatMasterpiece66=副词|时间，|与副词|地方|它说:|(章|对副词|时间，|与副词|地方)|副词|时间|它是:|一个名词|时间|宾格|与暗示|(中)|就像|一天，|夜晚，|清晨，|清晨，|和前一天休息的时间|今明两天，|深夜人的第一第三|到了中午，午夜|和晚上，|和永远/总是/无止境的|和很长的时间，|和一些时间。|和什么|是类似于|那。|我说:|副词|它的意思|in|语言:|容器容器|和预期|由它|in|自定义|语法学家的|对象|在它，|它是|两种:|第一:|副词|时间，|和第二个:|副词|地方。|对于|副词|时间:|然后它是|短语|从|名词|其中|是指|upon|时间|宾格|与表达式|引用|upon|意义|事件的发生|那|意义|在它，|与注意到|意义|(在)|引用|upon|状语，|和那|示例|你说:|(我禁食|这一天|星期一的/秒)|然后当然|(一天|星期一的/秒)|副词|时间|对象|在它，|它是|宾格|对你所说:|(封斋)|和那|操作的动词|引用|upon|意义|它是|禁食，|和这个词|upon|注意到|意义|(在)|其中:|那|禁食|发生了|in|这一天|所提到，|与差异|你说:|(恐惧|懒人|这一天|测试)|然后如果|意义|那|是它|恐惧|一个自我|这一天|测试的|并不是|它的意思|他|恐惧|东西|发生的事情|打开|此|一天。|知道|那|时间|划分|into|两个部分:|第一|具体/有关，|和第二个|模糊/不清楚。|对于|具体/有关|然后它是|(什么|是指|upon|固定|特定|测量/金额|从|时间。|和|模糊/不清楚|然后它是|(什么|是指|upon|固定|其他比|特定|而不是|测量/金额)。|和示例|特定/有关:|月，|和一年，|一天，|和一年，|又一周。|和示例|模糊/不明:|目前，|和时间，|和时间，|和一些时间。|和每个|一|从|这两个|种类|许可证|它的立场|upon|它|是一个对象|在它。|肯定|提到|作者|从|表达式|引用|upon|时间|二|十|表达式:|第一:|(天)|它是|从|日出|黎明的|到|设置|太阳，|你说:|(我禁食|一天)|或者|(我禁食|这一天|星期四的五次)|或者|(我禁食|1 天|长)。|和第二个:|(夜)|它是|从|设置|太阳的|到|日出|黎明，|你说:|(幽自己|晚上|最后/昨天)|或者|(幽自己|住一晚)|或者|(幽自己|晚上|星期五)。|和第三个:|(清晨)|它是|时间|什么|介于|祷告|黎明的|日出|太阳，|你说:|(拜访了我|我的朋友|清晨|周日的/第一)|或者|(他拜访了我|清晨)。|和第四个:|(清晨)|它是|第一|一天，|你说:|(我来看你|清晨|星期六/安息日)，|并且|(我来看你|清晨)。|和第五个:|(黎明黎明前的时间)|它是|最后一次|夜的|只是之前|黎明，|你说:|(我已修订|这一课|只是之前黎明/黎明)。|而第六:|(明天)|它是|一个名词|这一天|其中|之后|你的一天|其中|您|在它，|你说:|(如果|你来到我身边|明天|我将以你为荣)。|和第七个:|(第一夜的黑暗/黄昏的三)|它是|一个名词|第三名|夜的|第一，|你说:|(我会去拜访你|第一第三夜的 / 黄昏)。|和第八:|(午夜至中午时/前本初子午线)|它是|一个名词|时间|其中|开始时间|从|第一|一半|夜的|第二|到|中午的经络，|你说:|(旅行|我的兄弟|午夜到中午)。|和第九届:|晚上 (后本初子午线)|它是|一个名词|时间|其中|开始时间|从|中午的经络|到|一半|半夜了，|你说:|(到达/达成|火车|由我们|在晚上)。|和第十届:|永远/总是/无尽|和第一次|十:|(长时间):|和每个|从这两个|一个名词|为副词|未来的|其中|非|目的/目标|对它的结局，|你说:|(不|我会交朋友/成为陪朋友 /|那些邪恶的人|过)|并且|(不|我已经犯下|邪恶|对于很长的时间)。|和第二个|十:|(一些时间)|它是|一个名词|为副词|含糊不明|其他比|知道|开始|和也不|结束|你说:|(我成了朋友|阿里|一些时间|从|岁前)。|和加入|对那|什么|其类似|从|每个|名词|引用|upon|副词:|是否|was|具体/有关|示例|上午，|和上午，|或者|was|模糊/不清楚/晦涩|示例|时间，|每小时，|并时刻/短时间/时，|和时间，|并时刻/短时间/时;|然后当然|这些|和那的|它的例子|它是允许允许 /|宾格|每个|一|从他们|upon|它|是一个对象|在它。|副词|地方|它说:|与副词|地方|它是:|一个名词|地方|宾格|与暗示|(在)，|就像:|前面，|和隐藏，|和前面的|和隐藏，|及以上，|及以下，|与在/由/，|和对面/面对/脸去面对，|和对面/面对/脸去面对，|和前面的|和那里/在那边，|在这里，|和什么|是类似于|那。|我说:|当然|你理解|在什么|上一页|副词|时间，|和它|划分|into|两个部分:|具体/有关，|模糊/模糊/不清不楚，|和你的理解|那|每个|一|从这两个|允许许可证 /|其宾格|upon|它|是一个对象|在它。|知道|此处|那|副词|地方|短语|从|(名词，|引用|upon|这个地方，|宾格|与表达式|引用|upon|意义|发生|在它|通过注意/观察|意义|(在)|是指|upon|在状语。|和它|还|划分|into|两个部分:|具体/有关，|和模糊/模糊/不清楚/非特异性的;|和|具体/有关|然后是:|(这其中|为它|形状|和限制|局限性)|例如:|房子，|和清真寺，|和花园，|和花园;|和|模糊/模糊/不清楚/非特异|然后是:|(这其中|非|为它|形状|也不是|限制|局限性)|例如:|在后面，|和前面。|而不是|允许许可证 /|那|让宾格|upon|它|一个对象|在它|从|这两个|部件|除了|第二，|它是|模糊/模糊/不清楚;|对于|第一|-|它是|具体/有关|-|然后喜欢|其所有格|由粒子/介词|所有格的|引用|upon|本意，|就像:|(幽自己|in|这座清真寺)|并且|(我参观|阿里|in|他的房子)。|肯定|提到|作者|从|表达式|引用|upon|地方|三|十|表达式:|第一:|(在前面的)|就像:|(我坐|前面|这位教授|很好-mannered /-行为端正)。|和第二个:|(隐藏)|就像:|(骑/移动|行人|延迟|乘客或骑手)。|和第三个:|(在前面的)|就像:|(走|该名警察|早于/的前面|领导/指挥官/王子)。|和第四个:|(隐藏)|就像:|(站在|崇拜者|其中一些|延迟|其他人)。|和第五个:|(上图)|就像:|(我坐|上方|椅子上)。|而第六:|(下)|就像:|(站在|那只猫|下方|表)。|和第七个:|(与/上或其附近)|就像:|(为默罕默德|一站/等级|带有|这位教授)。|和第八:|(详细)|就像:|(旅行/走|带有|所罗门|他的弟弟)。|和第九届:|(相对于 / 面临)|就像|(对我们来说|一座房子|相对于 / 面临|尼罗河)。|和第十届:|(相对于 / 面临)|就像|(坐|我的兄弟|相对于 / 面临|你的弟弟)。|和第一次|十:|(对面到/面对/在前面的)|就像:|(坐|我的兄弟|在前面的/对面|这房子|你的弟弟)。|和第二个|十:|(那里)|就像|这句话|真主|最高:|(和我们亲近了|有|others)(26:64)。|第三个|十:|(在这里)|就像|你说:|(坐|默罕默德|此处|一个时刻)。|和示例|这些|表达式|每个|这其中|提到|upon|一个地方|模糊/模糊/不清楚/非特异性，|就像:|在右边，|和左边。|问题|和练习/演习|1-|此培训完成后，受众能够做些什么?| Yin|副词吗?|进入|几个|部件|划分|副词吗?|此培训完成后，受众能够做些什么?| Yin|副词|时间吗?|进入|几个|部件|划分|副词|时间吗?|生成|三|示例|in|一个句子|有意义|为副词|时间|指定/相关/有关，|与同三|示例|其他|为副词|时间|含糊不清 / 晦涩 / 不清楚，| Yin|作宾格|upon|它|是一个对象|在它|每个|副词的|时间吗?|2-|生成|每个|一|从|表达式|给出了|一个对象|在它|in|一个句子|有意义，|与指定|它的意思:|前三分之一的晚上/黑暗/黄昏，|午夜到早上/中午，|时间，|稍等，|上午晨光，|明天。|3-|此培训完成后，受众能够做些什么?| Yin|副词|地方吗?|此培训完成后，受众能够做些什么?| Yin|副词|地方|目前还不清楚/模糊/模糊?|此培训完成后，受众能够做些什么?| Yin|副词|地方|指定/相关/有关，|闭合|三|示例|为每个|从|副词|地方|目前还不清楚/模糊/模糊，|与副词|地方|具体/相关/有关，| Yin|作宾格|upon|它|是一个对象|在它|每个|副词|地方吗?|4-|提及|七|句子|描述|在它|你的行动|在这一天|星期五，|与条件|那|包含|每个|句子|upon|一个对象|在它。
GreatMasterpiece67=条件|它说:|(章|条件)|条件|等于:|名词，|宾格|解释|为此，|是模糊/模糊/可疑|从|条件时|就像|你说:|(来了|宰|骑马)|并且|(我骑|那匹马|它胜过一切)|并且|(我见过|仆人|真主|骑马)|和什么|是类似于|那。|我说:|条件|in|语言|(什么|在上面|人类|从|好|或者|坏或邪恶)|它是|in|术语|语法学家的|短语|从|(名词，|附加/额外，|宾格|解释|为此，|是模糊/模糊/可疑|从|条件/情况)。|和我们说:|(名词)|包含|清除|举个例子|(笑)。|输入|你说:|(来了|默罕默德|笑着说)|包括|解释|与清除|举个例子|(笑)|in|你说:|(来了|默罕默德|他笑着说)|然后当然它|在|解释|你说:|(笑)|和像那样|我们说:|(来了|默罕默德|与他|他的弟弟)|然后当然它|在|解释|你说:|(伴随着|他的弟弟)。|和我们说:|(额外/其他)|它的意思|它|不是|部分|从|演讲/词;|那时/因此免费|从它|谓词。|和我们说:|(宾格)|那时/因此免费|从它|主格|和所有格。|当然什么|让宾格|条件|与动词|和类似于|动词:|像这个名词|积极元素/分词，|和不定式|与副词，|和名词|指向/示范。|和我们说:|(解释|为此，|晦涩/含糊不清|从|条件)|它的意思|那|条件|解释|什么|为隐藏|和隐蔽|从|说明|那些拥有|知识|或者|其他比他们。|然后|事实上它|might|被|一种解释|为描述|活动元素的|就像:|(来了|仆人|真主|骑马)|或者|解释|为描述|对象/行事|通过它，|就像:|(我骑|那匹马|它胜过一切)，|和的可能|被|可能|对于这两种情况|在一起，|就像:|(我见过|仆人|真主|骑马)。|像什么|高光或来|条件|从|活动元素|/ 对象采取行动|由它|然后可能它|突出显示来|从|谓词，|就像:|(你|是我的朋友|真诚)，|和的可能|突出显示来|从|所有格|从粒子/介词|所有格，|就像:|(我通过|由后腿|骑马)|和的可能|突出显示来|从|所有格|附件/藏建设，|就像|它说:|最高:|(即|追随|信条|亚伯拉罕的|立式|)(16:123)|然后直立:|条件|从|亚伯拉罕，|和亚伯拉罕|是所有格|与罚的骂|更换|从|kasra，|它是|所有格|与附件/藏建设|(信条)|到它。|条件|状态|和条件|从动件/副教授|它说:|而不是| Yin|除了|无限期，|而不是| Yin|除了|之后|完成|演讲中，|而不是| Yin|其助理/追随者|除了|明确。|我说:|已找到|in|条件|那| Yin|无限期，|而不是|允许许可证 /|那| Yin|明确，|如果|来了|组成|在它|条件|正定|in|外观，|然后当然它|是发现|解释|此|确定性|由不确定性|示例|他们说:|(来了|领导者的指挥官/王子|在他自己的单独)，|然后当然|(关于他自己的单独)|条件|从|领导/指挥官/王子|然后它是|确定性|与附件/藏建设|到|代词|而且因为它|in|解释|是无限期|它是|你说:|(单/孤独)|那么喜欢你|你说:|(来了|领导者的指挥官/王子|独自一人)，|和示例|，|他们说:|(他发送它|苦苦挣扎/战斗)，|其中:|战斗，斗争 /|并且|(他们来了|第一个可用|然后第一次)|其中:|序列的命令。|与起源|in|条件|那|来自|之后|按照实践|讲话 》|和意义|实现和完成|感言:|那|需要|动词|其积极的元素|和主题|其谓词。|也许|它是有必要|先于|条件|upon|全部|部件|讲话 》|像什么|If|was|条件|名词|质疑/疑问句，|就像:|(如何|什么时候到|阿里)|那么如何:|一个名词|质疑/疑问句|结构|upon|罚的骂|in|地方|宾格的|条件|从|阿里，|而不是|允许许可证 /|延迟|名词的|质疑/疑问句。|包括|in|副教授/追随者|条件|那| Yin|明确，|然后不|允许许可证 /|那| Yin|无限期|与其他比|理由及有良好的原因。|从什么|辩解/使人有理由|来自|条件|从|无限期|那|开始|条件|在其上，|像这句话|诗人:|玛雅|被遗弃的废墟/遗骸|是一座房子|它显示/变得可见|好像是|损坏/不完美/亮剑|然后抛弃了废墟/仍然是:|条件|从|(房子)|和房子|无限期|和辩解|查找|条件|从它|它前面|在上面。|从什么|辩解|查找|条件|从|无限期|那|指定|此|无限期|与附件/藏建设|或者|描述|然后示例|第一个|in|它说:|最高:|(在|四|天/期|equal)(41:10)|然后相等:|条件|从|(四)|它是|无限期，|和辩解|查找|条件|在它|为是它|附加所拥有，|和示例|第二个|这句话|诗人:|你保存|主啊|诺亚|和授予|给他|in|一艘船|大|中/穿越|大海|已加载|演习/练习|1-|付诸表决|in|每个|地方|从|地方|空闲|给出了|条件|适当:|(裁决)|returns|学生|努力工作|到|他的国家|......|() b|不要|吃饭|食品|......|() c|非|步行/旅行|在沿|这条路|......|() d|放入/磨损|你的衣服|......|() e|不要|睡眠|in|晚上|......|() f|returns|我的父亲|从|他的办公室/理事会政府|......|() g|不要|步行|in|地球|......|() h|我看见|哈立德|......|2-|地方|每个|名词|从|名词|给出了|条件|澄清|条件|活动元素的|in|一个地方|有意义:|高兴。|昂首阔步/诡诈。|光着身子。|热。|累了。|Unshoed。|努力工作/勤奋。|3-|生成|每个|名词|从|名词|给出了|条件|澄清|条件|对象/行事|由它|in|一个地方|有意义:|带着镣铐/绑起来/绑定。|令人伤心。|快。|清除/纯。|清洁。|新增功能。|逗乐所笑。|光明/闪光/杰出。|盛开。|快乐/开朗。|4-|描述|那匹马|四|句子，|与条件|那|来自|in|每个|句子|与条件。|练习/演习|upon|拐点|活用|这两句话|给出:|遇见我|后腿|哭泣，|我穿了|服装|新增功能。|响应/答案|1-|满足:|一个动词|过去时态|结构|upon|罚的骂|非|一个地方|为它|从|屈折变化，|和 tah|标志|女性的特质，|和名词|为保护，|和严|代词|演讲者/第一人|对象/采取行动|通过它，|结构|upon|苏坤|in|地方|宾格的|和后腿:|活动元素|满足|主格，|和一个标志|它主格的|damma|很明显，|而哭泣:|条件|澄清|条件|活动元素的|主格|与罚的骂|明显。|2-|戴:|一个动词|过去时态|结构|upon|罚的骂|应该|upon|它的结局|防止|从|其明显|函数|地方|与苏坤|来|与它|为推动|不喜欢|先后|四|元音|在什么| Yin|像这个词|一个人，|和 tah|代词|演讲者/第一人|活动元素|结构|upon|damma|in|地方|主格的|与服装:|对象/采取行动|由它|宾格|和标志|其宾格的|罚的骂|很明显，|新增功能：|条件|澄清|条件|对象/行事|由它|宾格|和标志|其宾格的|罚的骂|明显。|问题|此培训完成后，受众能够做些什么?| Yin|条件|语言|和术语吗?|此培训完成后，受众能够做些什么?|其中|来自|条件|从它吗?|是|来|条件|从|附加/拥有|到它吗?|此培训完成后，受众能够做些什么?|其中|包含|in|条件下，|和什么|其中|包含|in|副教授/追随者|条件吗?|此培训完成后，受众能够做些什么?|其中|辩解|查找|条件|从|无限期?|生成|条件|三|例子，|和应用|upon|每个|一|从他们|条件|条件|他们，每个人都|和改变他们。
GreatMasterpiece68=规格|它说:|(章|规范)|规格|它是:|名词，|宾格的情况下，|解释|为此，|不清楚|从|精华，|就像|你说:|(滴|扎伊德|汗水)|并且|(爆炸爆裂 /|巴克尔|在脂肪)|并且|(是好|默罕默德|人)|并且|(我买了|二十|书)|并且|(我拥有|九十岁|羊羊/女)|并且|(宰|是更光荣/高贵|比你|作为一位父亲)|并且|(他是更美丽|比你|在面部外观/外观)。|我说:|为规范|in|语言|有两层含义;|第一:|解释|没有任何例外/绝对，|你说:|我解释|因此/像这样，|你想要|那你|解释所解释;|和第二个:|分离|某些|事项|从|其他一些|你说:|我分离|人，|你想要|那你|分离|其中一些|从|其他一些。|与规格|in|术语|语法学家的|短语|从|(名词，|明确的名词，|宾格|解释|为此，|不清楚|从|精华|或者|关系/归因)。|然后我们说:|(名词)|它的意思|那|规格|非| Yin|一个动词|也不是|一个粒子。|和我们说:|(明确的名词)|为消除/离开|名词|解释，|然后如果|规格|非| Yin|一个句子|也不是|副词，|与差异|条件|像什么|以前|in|第一章。|和我们说:|(解释|为此，|不清楚|从|精华|或者|关系/归因)|指示|到|那|规格|upon|两种，|第一:|规格|本质/发声/口语，|和第二个:|规格|规格/归属/是显而易见的。|对于|规格|本质|-|并要求|还|规格|单数|-|它是|(这其中|引发|默默无闻|一个名词|提到|在它之前|完成|现实)|和是|之后|数字，|就像|它说:|最高:|(真正 i|锯|一|十|stars)(12:4)，|(真正|数量|个月|带有|真主|是两个|十|months)(9:36)|或者|之后|测量，|从|称重，|就像:|(我买了|一磅|油)|或者|干措施|就像:|(我买了|128 磅|小麦/干粒) 的|或者|地区，|就像:|(我买了|一个正方形|土地)。|和|规格|归因，关系说明|-|被称为|还|规格|这句话的|-|它是|(这其中|引发|默默无闻|属性/关系|in|一个句子|项|它)|它是|两种类型;|第一:|改变，|和第二个:|其他比|多变。|然后为|多变|然后它是|upon|三|种类:|那种|第一:|多变|从|活跃的元素，|和那|就像|(爆炸/爆裂|扎伊德|在脂肪)|起源|在它|(爆炸/爆裂|脂肪|扎伊德) 的|然后删除|附加/拥有|-|它是|脂肪|-|和正在发生|附加/拥有|到它|-|它是|扎伊德|-|它的地方，|然后先进|中国的崛起，|然后|来自|与附加/拥有|缺席失踪|然后是最后一个|upon|规范。|那种|第二:|多变|从|对象/行事，|和那|喜欢|它说:|最高:|(和规定作出突发|地球|rivers/springs)(54:12)|它的起源|(和规定作出突发|河流/弹簧|地球)|然后做|在它|示例|其中|之前。|那种|第三:|多变|从|主题|和那|就像|它说:|最高:|(I|更多|比你|在 wealth)(18:34)|和它的起源|(我的财富|是更多|于|你的财富)|然后删除|附加/拥有，|它是|(财富)|和正在发生|附加/拥有|到它|-|它是|代词|其中| Yin|是啊|演讲者/第一人|-|它的地方|然后先进|它的崛起|和分离;|因为|是啊|演讲者/第一人|代词|连接的|像什么|你明白，|它是|非|正在启动|有了它，|然后|来了|与附加/拥有|缺席失踪|然后是|规范，|然后成为了|什么|你看看。|和|其他比|多变|然后就像|(填充|容器|水)。|条件|规范的|它说:|而不是| Yin|除了|无限期，|而不是| Yin|除了|之后|完成|讲话。|我说:|包含|in|规格|那| Yin|无限期，|然后不|允许许可证 /|那| Yin|明确，|和|这句话|诗人:|我看见你|当后|那|你知道的|我们的脸/伟人|你转身离去|你会快乐/同意|你自己|阿伊斯|对于|Amr|然后如果|它说:|(自我)|一种规范，|并不是|()|此|(另外/额外粒子)|正定|每当|有必要|从它|已找到|规格|明确，|而是|它是|另外|非|目的是|什么|输入|明确;|然后它是|无限期，|它是|可以接受|为此，|提醒我们|从|条件。|而不是|允许/许可证|in|规格|那|先于|upon|关于它，其动词|而是|非|已找到|除了|之后|完成|演讲，|其中:|之后|完成和满足感|动词的|由其活跃的元素，|和主题|由其谓词。|运动/演习|1-|请参阅|种类|规范的|很多细节|in|句子|给出:|我喝了|一杯|水，|我买了|磅/quintar|亲爱的|我拥有|十|小块|黄金，|我栽培播下了|一亩|棉制|我看见|一|十|马兵，|我骑|火车|五十|乘客/旅行，|默罕默德|是更完美|从|哈立德|在字符|和更高贵|作为一个人|和更纯|在无罪/完整性，|填充|亚伯拉罕 ·|与骄傲。|2-|付诸表决|in|每个|地方|从|地方|空闲|从|例子|规格|适当:|(裁决)|金色|是更昂贵|......|于|银。|() b|铁|是强|......|于|铅。|() c|学者们|是最诚实|人|......|() d|学生|知识|是更光荣/高贵|......|于|无知的人。|() e|长颈鹿|是最高的|动物|......|() f|太阳|是更大|......|于|地球。|() g|我吃了|五|十|......|() h|我喝了|一杯|......|3-|生成|每个|名词|从|名词|给出了|规格|in|一个句子|有意义:|大麦，|甘蔗和读取，|自然/字符，|道德，|喝酒，|笑，|力量，|勇气。|4-|给|三|句子| Yin|in|每个|句子|从他们|规格|前所未有|与名词|计数，|与条件|那| Yin|名词|计数|主格|in|一|和宾格|in|第二|和所有格|in|第三部分。|练习/演习|upon|拐点|活用|这两句话|给出:|默罕默德|是更高尚/光荣|于|哈立德|自己作为一个人，|我有我|二十|手臂长度|丝绸。|答案/响应|1-|默罕默德:|一门学科，|主格|通过在开始，|和标志|它主格的|damma|很明显，|更多高尚/光荣:|谓词|问题，|主格|按主题、|和标志|它主格的|damma|很明显，|从|哈立德:|所有格|和所有格|相关|与更多高尚/光荣，|自己作为一个人:|规格|属性/关系/描述|多变|从|主题|宾格|和标志|其宾格的|罚的骂|明显。|2-|与:|副词|地方|相关|与缺席/失踪|谓词|提出了一种，|和与|附加/拥有|和严|演讲者/第一人|连接藏有|到它，|结构|upon|苏坤|in|地方|所有格，|二十:|一门学科|被延迟的|主格|开头，|和标志|它主格的|waw|更换|对于|damma，|因为它|是一种扩展|为复数形式|男性|声音，|手臂长度:|规格|二十多个年头，|宾格|与罚的骂|很明显，|丝绸:|规格|手臂长度|宾格|与罚的骂|明显。|问题|此培训完成后，受众能够做些什么?| Yin|规格|语言|和术语吗?|进入|几个|部件|划分|规格吗?|此培训完成后，受众能够做些什么?| Yin|规格|本质吗?|此培训完成后，受众能够做些什么?| Yin|规格|属性/关系/描述吗?|与什么|被称为|规格|本质吗?|与什么|被称为|规格|属性/关系/描述吗?|此培训完成后，受众能够做些什么?|其中|发生|之前|规格|本质吗?|生成|为规范|本质|三|示例|不同|和活用|每个|一|从他们吗?|进入|几个|部件|划分|规格|属性/关系/描述|多变的吗?|生成|为规范|多变|从|活动元素|和从|对象/行事|和从|主题|闭合|为规范|属性/关系/描述|其他比|改变，|什么|的|条件|规范吗?|此培训完成后，受众能够做些什么?|防止|从|规格|非|来|除了|之后|完成|讲话吗?|生成|为规范|到它|规范。
GreatMasterpiece69=异常/驱逐|它说:|(章|例外/驱逐)|和颗粒|异常的|八项，|和他们是:|除外，|和其他比，|除了 / 其他比/与不同的是，|除了 / 其他比/与不同的是，|以及是否，|除了分开从|除了分开从|除了分开从。|我说:|异常|它的意思|in|语言|绝对/完成|去除/考虑了，|它是|in|术语|语法学家的|短语|从|(拿出/删除|通过除外|或者|一|它的姐妹，|东西|如果不是|那|以出/删除|然后它本来.|进入|在什么|之前|工具/工具)|和它的例子|你说:|(成功了|学生|除了|Amir)|然后当然|你拿掉删除|与你说|(除外|Amir)|只有一个|学生，|他是|Amir，|如果不是|那|以关闭删除|然后将已|Amir|进入|in|这句话|学生的|取得了成功。|知道|那|工具/工具|异常的|有很多，|和肯定|提到|从他们|作者|八|工具/文书，|和那些的|提到他们|从他们|upon|三|种类:|那种|第一:|这其中| Yin|一个粒子|总是|它是|(除外)。|那种|第二:|这其中| Yin|一个名词|总是|和他们是|四、|和他们是:|除了 / 以外 (不像)|与限制|和 kasra|所见，|并且|除了 / 以外 (不像)|与限制|和 damma|所见，|并且|(是否)|扩展名|和罚的骂|所见，|并且|(其他比)。|那种|第三:|这其中| Yin|一个粒子|有时|和是|一个动词|有时|其他，|和他们是|三|工具/文书，|和他们是:|(除了分开从)|并且|(除了分开从)|并且|(除了分开从)。|这项裁决|被排斥|通过除外|它说:|然后除外|通过除外|让宾格|当|was|这次演讲|完成|积极，|就像:|(以发言|人民|除了|扎伊德)|并且|(左|人民|除了|) Amr|如果|was|这次演讲|负|完成|允许允许的话|在它|替代|宾格|upon|例外，|就像:|(不|站在|人民|除了|扎伊德)|并且|(除外|扎伊德)|如果|was|这次演讲|不完整|was|upon|根据|功能/因素，|就像:|(不|站在|除了|扎伊德)|并且|(不|我击中/击/击败|除了|扎伊德)|并且|(不|我通过|除了|由扎伊德)。|我说:|知道|那|该名词|发生|之后|(除外)|三|条件;|条件|第一:|有必要|宾格的|upon|例外，|条件|第二:|可容许性|其下面的|为此，|早于|(除外)|upon|它|替代|从它|带有|可容许性|其宾格|upon|例外，|条件|第三:|必要性|其下面的|upon|根据|什么|要求|函数的|提到|之前|(除外)。|和解释|，|那是|这次演讲|其中|之前|(除外)|作为为|那| Yin|完成|积极，|至于|那| Yin|完成|消极，|至于|那| Yin|不完整|而不是| Yin|然后|除了|消极。|和意义|正在|这次演讲|项|完成:|那|提到我的|在它|除外|从它，|和意义|其被|不完整|那不|提到我的|在它|除外|从它，|和意义|正在|积极，|那不|它之前|否定|或者|它的同类，|和类似|否定:|禁止，|并质疑/疑问句，|和意义|正在|消极，|那|它前面|一|这些|东西。|然后如果|was|这次演讲|项|完成|正|有必要|宾格|名词的|发生|之后|(除外)|upon|异常|就像|你说:|(站在|人民|除了|扎伊德)|和你说:|(左|人民|除了|) Amr|然后扎伊|和 Amr:|两个除外|从|语音|完成|为一提|除外|从它|-|它是|(人民)|in|第一|并且|(人民)|in|第二|-|这次演讲|带有|那|是积极的|为缺乏的|来之前|否定|或者|其类似;|在必要的时候|宾格的他们两个，|与此| Yin|条件|第一次。|如果|was|这次演讲|项|完成|负|这被允许的|在它|要遵循|upon|补偿与替换|或者|宾格|upon|例外，|就像|你说:|(不|站在|人民|除了|扎伊德)|然后扎伊德:|异常|从|语音|完成|为被提及|除外|从它，|它是|人，|和演讲|带有|那|否定|来之前|(不)|否定;|然后允许|在它|跟随;|然后你说|(除外|扎伊德)|与主格;|因为|除外|从它|主格，|和替代|主格的|是主格，|并允许|在它|upon|一点儿|宾格|upon|例外;|然后你说:|(除外|扎伊德)|与此| Yin|条件|第二次。|如果|was|这次演讲|项|不完整，|而不是| Yin|除了|消极，|was|异常|upon|根据|什么|之前|(除外)|从|因素/原因/功能;|然后如果|was|功能|要求|主格|upon|活动元素|它主格|在其上，|就像|(不|出席|除了|Ali)，|然后如果|was|功能|要求|宾格|upon|对象/行事|其宾格的|在其上，|就像|(不|我看见|除了|阿里)|如果|was|功能|要求|所有格|与粒子|从|颗粒/介词|所有格的|其所有格|通过它，|就像:|(不|我通过|除了|由扎伊)|与此| Yin|条件|第三个。|异常|与其他比|和它的姐妹|它说:|和异常|与/除以外，与不同的是，|除了 / 其他比/与不同的是，|除了 / 其他比/与不同的是，|和其他比|所有格|非|其他。|我说:|名词|发生|之后|工具|从|这些|工具/颗粒|四|已找到|其所有格|与附件/藏建设|工具|到它，|对于|工具|本身|然后当然它|需要|这项裁决|名词的|发生|之后|(除外)|upon|解释/详细信息|其中|以前:|然后如果|was|这次演讲|完成|正|其宾格|有必要|upon|例外，|就像:|(站在|人民|除了|扎伊德)|如果|was|这次演讲|完成|负|其以下|为此，|在它之前|或者|其宾格|就像:|(不|拜访了我|任何人|除了|高级/好)，|或:|(除外|高级/好)|如果|was|这次演讲|不完整|负|它将进行|upon|根据|功能: 起因，|就像|(不|连接|与其他比|高级/好)。|异常|与除分开从|和它的姐妹|它说:|和异常|与除分开从|除了分开从|除了分开从|它允许|其宾格|和它的所有格，|就像:|(站在|人民|除了|扎伊德，|与扎伊)|并且|(除外|Amr|和 Amr)，|并且|(除外|巴克尔|和巴克尔)。|我说:|名词|发生|之后|工具|从|这些|颗粒|三|许可证|给你的|那|其宾格的情况下，|和许可证|给你的|那|其所有格|及原因|in|那|那是|这些|工具/工具|被用作|动词|有时，|和使用|颗粒|有时|其他|upon|什么|之前，|然后如果|你表明它们是|动词|宾格|什么|之后他们|upon|它|是对象/采取行动|通过它，|和表现的元素|代词|隐藏|必要的义务，|如果|你表明它们是|颗粒|所有格|什么|是在他们以后|upon|它|是所有格|与他们。|和原因|这|频繁的改变|在什么|当|没有|以前来过|在他们身上|(不)|不定式;|然后如果|来之前|upon|一|从他们|(不)|是必不可少的|宾格|什么|是在他们之后，|和原因|，|那是|(不)|不定式的|非|进入|除了|upon|动词;|然后他们|是动词|在任何情况下|If|之前他们，|然后就像:|(站在|人民|除了|扎伊德)|许可证|在它|宾格|(扎)|和它的所有格，|和一样:|(站在|人民|非|其他比|扎伊德)|非|允许|在它|除了|宾格|(扎)|和阿拉|光荣|被他|最高|而且他知道。|问题|此培训完成后，受众能够做些什么?| Yin|例外情况|语言|和术语吗?|此培训完成后，受众能够做些什么?|的|工具/工具|例外?|进入|几个|部件|划分|工具/工具|例外?|几个|条件|该名词|发生|之后|除了吗?|当|是必要的|宾格|名词的|发生|之后|除了吗?|当|许可证|宾格|名词的|发生|之后|除了|及其追随者|为此，|在他们面前是吗?|此培训完成后，受众能够做些什么?|意思是|正在|这次演讲|完成吗?|此培训完成后，受众能够做些什么?|意思是|正在|这次演讲|负面?|此培训完成后，受众能够做些什么?|是执政的|名词的|发生|之后|其他比/除/不像吗?|如何|是屈折|其他比/除/不像吗?|此培训完成后，受众能够做些什么?|是执政的|名词的|发生|之后|除了分开的吗?|条件|运作的|(没有)|功能|事实上当然|它说:|(第章|(没有))|知道|那|(没有)|让宾格|无限期|与其他比|noonation|If|之间的自然数|无限期|也没有|重复|(没有)|就像|(没有|人员|in|那所房子)。|我说:|知道|那|(没有)|否定|万能|运作|功能|(事实上当然可以)|然后使宾格|名词|口述/表达式|或者|代替的|和使主格|谓词。|它是|非|运作|此|函数|重要|除了|四|条件:|第一|那| Yin|其名词|无限期。|第二种:|那| Yin|其名词|已连接|与它:|其中|其他比|分离|从它|如果|与谓词。|和第三个:|那| Yin|其名词|无限期|也。|和第四个:|那不|重复|(没有)。|然后|知道|那|名词|(没有)|upon|三|类，|第一|奇异，|和第二个|连接藏有|到|无限期，|第三个|类似|与附加/拥有。|对于|单数|in|此|章，|中和|这一章|称呼，|和是它:|(这其中|不是|附加/拥有|也不是|类似|与附加/拥有)|然后输入|在它|双，|和复数|破碎的|和复数|男子气概|声音，|和复数|女性气质|声音。|和其裁决|它|生成/是结构|upon|什么|让宾格|由它:|然后当|was|其宾格|与罚的骂|它的结构|upon|罚的骂，|就像:|(没有|人员|in|首页)，|如果|was|其宾格|与阎|-|和那|双|和复数|男子气概|声音|-|结构|upon|是啊|就像:|(没有|两个男人|in|房子)|和什么时候|was|其宾格|与 kasra|更换|对于|罚的骂|-|和那|是复数|女性气质|声音|-|结构|upon|kasra，|就像:|(有没有|义人的妇女|今天)。|和|附加/拥有|in|宾格|与罚的骂|表观|或者|与那的|更换用代替|为它，|就像:|(没有|学生|知识|最恨的)。|和|类似|-|附加/拥有|-|它是|(这其中|已连接|与它|事情|从|完成|它的意思)|然后示例|附加/拥有|in|裁决:|其中|让宾格|与罚的骂，|就像:|(没有|直线度/美誉/义|他的身体状况的|其中|人民|是不喜欢)。|它说:|然后如果|没有|后立即来|需要|主格|和需要|重复|(没有)|就像:|(不|in|这房子|一个男人|也不是|一个女人)|然后如果|被重复|它是允许有|它的功能|以及它的撤销，|然后如果|你想要|你说:|(没有|人员|in|这房子|也不是|女人)|如果|你想要|你说:|(不|一个男人|in|这房子|也不是|一个女人)。|我说:|当然|你知道的|那|条件|重要|功能的|(没有)|运作|(当然/的确)|四、|与此|讨论|in|解释|执政的|If|未实现|条件|从|条件|四|之间的自然数。|和指的|那|是它|If|发生|之后|(没有)|是确定的|需要|取消|(没有)|和它的重复，|就像|(不|默罕默德|拜访了我|也不是|巴克尔)|如果|分离|介于|否|和它的名词|分离|它，|重要|诸如此类|其取消|和其重复|就像|(没有|在那里|不好的影响|和没有|他们|从它|将 intoxicated)(37:47)|然后坏的影响:|一门学科|延迟，|又在那里:|有关|与删除|谓词的|来之前，|并且|(没有)|否定|unpointed，|如果|重复|(没有)|非|有必要|它的功能，|而是|允许许可证 /|它的功能|If|完成|剩下的|条件，|并允许许可证 /|其注销;|然后你说|upon|功能|(没有|人员|in|首页|也不是|一个女人)|与罚的骂的|人员|和一个女人，|和你说|upon|取消|(不|一个男人|in|首页|也不是|一个女人)|与的主格|一个男人|和一个女人。|问题|此培训完成后，受众能够做些什么?|其中|让|(没有)|否定|为普遍性吗?|此培训完成后，受众能够做些什么?|条件|需要|运作|(没有)|否定|普遍性吗?|进入|几个|部件|划分|名词|不是吗?|此培训完成后，受众能够做些什么?|是执政的|名词的|(没有)|奇异吗?|此培训完成后，受众能够做些什么?| Yin|单数|in|一章|(没有)|和呼格吗?|此培训完成后，受众能够做些什么?|是执政的|名词的|(没有)|If|was|附加/拥有|或者|类似|与它吗?|此培训完成后，受众能够做些什么?|是执政的|If|重复|(没有)|否定?|此培训完成后，受众能够做些什么?|是执政的|If|发生|之后|(没有)|否定之否定|是确定的吗?|此培训完成后，受众能够做些什么?|是执政的|If|分离|介于|(没有)|和它的名词|分离吗?
GreatMasterpiece70=呼格|它说:|(章|称呼)|呼格|五|类型:|单数|专有名词，|与不确定性|已知或意欲，|与不确定性|其他比|已知或意欲，|和附加/拥有，|和类似|与附加/拥有。|我说:|呼格|in|语言|它是:|要求/希望|它拉近距离|绝对，|中和|术语|语法学家的|它是|(要求/受通缉|它拉近距离|与 O|或者|一|它的姐妹)|和的姐妹|(O)|他们是|五|就像|(O 扎伊|靠近)|并且|(O)|就像|(O|亚伯拉罕 ·|理解)|并且|(O)|就像:|O|树木|Khabur|什么是与你|美丽的绿色叶子|这是因为如果你是|非|伤心|对于|儿子|塔里夫的|并且|(O)|就像|(O|默罕默德|来吧)。|然后|呼格|upon|五|种类:|1-|单数|专有名词，|和肯定|过去式|in|一章|(没有)|反映|奇异，|和它的例子|(穆罕默德)|并且|(O 法蒂玛)|并且|(O 你两个穆罕默德)|并且|(O 你两个 Fatimas)|并且|(O 你所有穆罕默德)|并且|(O 你所有的 Fatimas)。|2-|无限期|目的是;|和它是:|其中|打算|与它|一|特定|与那的|是正确的|打来电话|由它的词|在他身上，|就像|(O 不公正)|你想要|一|其具体。|3-|无限期|其他比|目的是;|和它是:|其中|打算|由它|一|其他比|具体，|就像|说|华纳:|(O 疏忽的|注意到)|然后当然它|非|打算|一|具体，|而是|打算|每个|从|有关|在上面|表达|(疏忽的)。|4-|附加/拥有，|就像|(O 学生|知识|努力工作)。|5-|类似|与附加/拥有，|它是|这其中|高度重视|与它|事情|从|完成|它的意思，|是否|was|附件|与它|主格|有了它，|就像|(O 值得称道|他的行动)|或者|was|宾格|与它|就像|(O 存储器和观察员|对他的说教)|或者|was|所有格|用粒子/介词|所有格的|有关|与它|就像|(哦，爱人者|好)。|它说:|然后为|单数|专有名词，|与不确定性|目的|然后都是结构|upon|damma|从|其他比|noonation，|就像|(O) Zaid|并且|(啊)|和三个|剩余|宾格|否|其他。|我说:|If|was|呼格|单数|或者|无限期|目的|然后当然它|是结构|upon|什么|使它主格|与它;|然后如果|was|由主格|与 damma|然后当然它|是结构|upon|damma，|就像|(穆罕默德)|并且|(O 法蒂玛)|并且|(啊)|并且|(O 你所有 Fatimas)|如果|was|由主格|alef|更换|对于|damma|-|和那|是的对偶|-|然后当然它|是结构|upon|阿勒夫|就像|(O 你两个穆罕默德)|并且|(O 你两个 Fatimas)|如果|was|由主格|带有 waw|更换|对于|damma|-|和那|是复数形式|男子气概|声音|-|然后当然它|是结构|upon|waw|就像|(O 你所有穆罕默德)。|如果|was|呼格|无限期|其他比|目的|或者|附加/拥有|或者|类似|与附加/拥有|然后当然它|让宾格|与罚的骂|或者|什么|替换/替代品|为它|就像|(O 无知的人|学习)|并且|(O 懒人|是感兴趣的转机|upon|这其中|对你有好处)|就像|(O desirer|荣誉|工作|为它)|并且|(哦，爱人者|高级状态|坚持下去|upon|努力)|就像|(O desirer|in|电源/规则|不要|生气|从|工作)|并且|(O 是渴望的人|upon|好|踏踏实实)。|问题|此培训完成后，受众能够做些什么?| Yin|呼格|词法上|和术语吗?|此培训完成后，受众能够做些什么?| Yin|工具|电话吗?|生成|为每个|工具/工具|结合实例，|into|几个|部件|划分|呼格吗?|此培训完成后，受众能够做些什么?| Yin|单数|和使|为它|两个例子|不同，|什么| Yin|无限期|目的|带有|表示法?|此培训完成后，受众能够做些什么?| Yin|类似|与附加/拥有吗?|进入|几个|种类|是分裂|类似|与附加/拥有|带有|表示法|为每个|类型是什么?|此培训完成后，受众能够做些什么?|是执政的|呼格的|奇异吗?|此培训完成后，受众能够做些什么?|是执政的|呼格的|附加/拥有吗?|生成|为每个|种类|从|种类|呼格的|五|用两个例子，|和活用|一|从两个。
GreatMasterpiece71=对象/行事|为本身|它说:|(章|对象/行事|从|其缘故/原因)|和它是:|名词，|宾格|提到我的|解释|原因|发生|行动，|就像|你说:|(站在|扎伊德|出于尊重|为 Amr)|并且|(我来找你|渴望|那对你有好处)。|我说:|对象/行事|从|其缘故/原因)|-|它是说|(对象/行事|它的缘故/理由)，|并且|(对象/行事|为本身)|-|它是|in|术语|语法学家的|短语|从|(名词，|宾格|其中|提到我的|解释|原因|发生|行动)。|和我们说:|(名词)|包含|清除|和解释|由它。|并且必须|in|名词|其中|发生|对象/采取行动|为它|从|那|包括|在它|五|事情:|第一:|那| Yin|动词不定式。|和第二个:|那| Yin|改变，|和意义|其被|多变|那不| Yin|引用|upon|一个函数|从|操作|物理/的四肢|像的手|和舌头|示例|(阅读)|并且|(打)。|和第三个:|那| Yin|原因|为什么|是在它之前。|和第四个:|那| Yin|同意|带有|它的功能/它的影响|in|时间。|和第五个:|那|同意|带有|它的功能/它的影响|in|活跃的元素。|和示例|名词的|包含|为这些|条件|(对学科)|从|你说:|(我打|我的儿子|对学科)|然后当然它|是不定式|它是|多变;|因为它|不是|从|操作|物理/的肢体，|它是|原因|为击中，|和它|同意|带有|(打)|in|时间，|中和|活动元素|也。|和每个|名词|实现|这些|条件|允许许可证 /|在它|两件事:|宾格|和所有格|与粒子|从|颗粒/介词|所有格的|引用|upon|原因|像林。|知道|那|该名词|其中|发生|对象/采取行动|为成因的缘故|三|条件:|第一:|那| Yin|已连接|与。|第二种:|那| Yin|附加所拥有。|第三:|那| Yin|空闲|从|() / 明确的粒子|和从|拥有/附件建设。|中和|全部|这些|条件|允许/许可证|在它|宾格|和所有格|与粒子/介词|所有格，|除了|它|might|首选项|一|两种方式，|和的可能|这两个是平等|in|允许的职权范围。|然后如果|was|已连接|与|然后主要是|在它|那|是由所有格|引用|upon|究其原因，|就像:|(我打|我的儿子|为纪律)|很少会|其宾格。|如果|was|附加/拥有|准许禁止|其可容许性|同样|那|其制作的所有格|用粒子/介词|如果|是宾格|就像:|(我来看你|不爱|你良好的礼仪)|或者|(我来看你|为爱|你良好的礼仪)。|如果|was|空闲|从|() / 明确的粒子|和从|附件/藏建设|然后主要是|在它|那|它使宾格，|就像:|(我站|出于尊重|为老师)|和很少|其所有格|用粒子/介词，|和阿拉|知道。|问题|此培训完成后，受众能够做些什么?| Yin|对象/行事|它的缘故/理由吗?|此培训完成后，受众能够做些什么?|其中|要求|in|名词|其中|发生|对象/采取行动|它的缘故/理由吗?|几个|条件|该名词|发生|对象/采取行动|为本身?|此培训完成后，受众能够做些什么?|是执政的|对象/行事|为本身|连接的|与|和附加/拥有吗?|生成|三|示例|为对象/行事|为成因的缘故|与条件|那| Yin|第一|连接的|与|和第二个|附加/拥有|第三个|空闲|从|的|与附件/藏建设|和活用|每个|一|从他们，|并引用|in|每个|示例|这其中|允许/许可证|在它|从|方式|带有|引用|最有可能|If|是的。
GreatMasterpiece72=对象/行事|与它 / 伴奏|它说:|(章|对象/行事|与它 / 伴奏)|和它是:|名词，|宾格的情况下，|其中|被提及|与指定|从|谁是做对|与它|行动，|就像|你说:|(来了|领袖|与军队)|并且|(成为水平|水|用木头)。|我说:|对象/行事|与它 / 伴奏|带有|语法学家|等于:|(名词，|附加/额外，|宾格|与动词|或者|什么|在它|意义|动词的|和它的字母，|引用|upon|人/所有者|其中|发生会发生|操作的动词|其伴奏|之前|由 waw|用作|在一起/公司/与|在语言中)。|然后我们说:|(名词)|包含|单数|和双|和复数，|阳性|和女性|和解释|与它:|名词|清楚|无|解释，|并考虑|从它|动词|和颗粒|和这句话。|和我们说:|(额外/其他)|它的意思|它|不是|一个支柱|in|演讲;|那么就不是|活跃的元素，|而不是|一门学科|而不是|谓词|取出|与它|支持/主要问题，|就像|(共享|宰|与 Amr)。|和我们说:|(宾格|与动词|或者|什么|在它|意义|动词的|和它的字母)|引用|upon|那|病原体|in|对象/行事|与它 / 伴奏|upon|两种:|第一:|动词，|就像|(在场|领袖|与军队)。|第二种:|名词|引用|upon|意义|动词的|组成|upon|它的字母，|像名词/分词|活动元素的|in|就像|(的领导|存在|与军队)。|和我们说:|(前面|由 waw| Yin|在措辞中使用|in|引用|upon|在一起/公司/与)|起飞|由它|名词|之前|由 waw|非|在措辞|in|引用|upon|伴奏，|就像|(出席|默罕默德|和哈立德)。|知道|那|名词|发生|之后|waw|upon|两种:|1-|这其中|指定|其宾格|upon|它|是/对象采取行动|与它 / 伴奏。|2-|其中|允许/许可证|其宾格|upon|那|并且跟随它|为此，|在它之前|in|其拐点/词形变化|皮带机|在上面。|和|那种|第一个|然后是它的地方|If|非|正确|要关联|这其中|在以下日期之后|waw|到那的|在它之前是|in|这项裁决，|就像|(我是|移动/旅行|与山)|就像|(I 研究和订正|带灯)|然后当然|这座山|非|正确|要关联|对发言者/第一人|in|旅游，|和像那样|那盏灯|非|正确|要关联|对发言者/第一人|in|学习所修改，|和肯定|作|作者|为此|种类|它说:|(成为水平|水|用木头)。|和|第二|然后是它的地方|If|正确|要关联|这其中|之后|waw|为此，|在它之前|in|信息裁决|就像|(出席|阿里|和默罕默德)|然后当然它|允许许可证 /|宾格的|(穆罕默德)|upon|它|对象/采取行动|与它 / 伴奏，|并允许许可证 /|它主格|upon|它|是友情|upon|(); Ali|因为|默罕默德|允许许可证 /|把它联系起来|带有|阿里|in|考勤、|和肯定|作|作者|为此|种类|它说:|(来了|领袖|与军队)。|问题|此培训完成后，受众能够做些什么?| Yin|对象/行事|与它 / 伴奏吗?|此培训完成后，受众能够做些什么?|目的是|与名词|在这里吗?|此培训完成后，受众能够做些什么?|目的是|额外/额外吗?|此培训完成后，受众能够做些什么?|其中|行为|in|对象/行事|与它 / 伴奏吗?|进入|几个|部件|划分|对象/行事|与它 / 伴奏吗?|生成|为对象/行事|与它 / 伴奏|其中|是发现|它主格|用两个例子，|闭合|为对象/行事|与它 / 伴奏|其中|允许许可证 /|其宾格|并且跟随它|为此，|在它之前是|用两个例子，|活用|两个例子|有哪些|in|这次演讲|作者，|与指定|in|每个|示例|从这两个|从|其中|种类|它是。|它说:|和|谓词的|(是) / 动词是|和它的姐妹|和的名词|(当然/的确) / 宾格粒子|和它的姐妹|然后当然|来之前|提到的两个|in|nominatives，|和像那样|追随者;|当然|来之前|那里。|我说:|从|接动名词做宾语|名词|(当然/的确) / 宾格粒子|和它的姐妹，|和的谓词|(是) / 动词是|和它的姐妹，|和从动件|宾格的|和肯定|来之前|解释|那|in|它的章节;|所以不|需要|对我们来说|到|重复|所有内容|从它。
GreatMasterpiece73=属格结构|从|名词|它说:|(章|属格结构的|从|名词)|属格结构|有三个|种类:|所有格|与粒子介词|和所有格|与附件/藏建设，|和追随者|所有格。|我说:|名词|所有格的|upon|三|种类;|和那|是的因为|所有格|为它|作为为|那| Yin|一个粒子/介词，|从|颗粒/介词|所有格的|其中|之前|它的解释，|in|第一|这本书的|而|会提到它|作者|之后|那，|和那|就像|() Khalid|从|你说:|(我的情分慈悲 /|upon|哈立德)|然后当然它|是所有格|通过后，|它是|一个粒子/介词|从|颗粒/介词|所有格，|和|那| Yin|所有格|该名词|附件/藏建设|一个名词|在它之前|到它，|和意义|财产/附件建设:|连接|第二个|第一，|和那|就像|(穆罕默德)|从|你说:|(来了|仆人的男孩|默罕默德)|然后当然它|是所有格|与原因 /|附件/藏建设的|(仆人或男孩)|到它，|和|那| Yin|所有格|该名词|其以下|为一个名词|所有格，|与那| Yin|形容词|为它，|就像|(区分/学习)|从|你说:|(我用了|知识|从|默罕默德|尊敬/学会)|或者|皮带机|在其上，|就像|() Khalid|从|你说:|(我通过|由穆罕默德|和哈立德)|或者|其他比|这两个|从|追随者|其中|之前|他们提到。
GreatMasterpiece74=它说:|和|所有格|与介词/颗粒|然后是:|什么|是由所有格|通过从，|和到/对，|和从，|及后，|和，|和一些/许多/也许，|和呸，|和 kaf，|和林|和之前的粒子的介词|誓词 》:，|和他们是:|waw|和呸，|和 tah，|或者|带有 waw|可能，|和与以来，|和自 / 前。|我说:|那种|第一个|从|属格结构:|所有格|由介词/粒子|从|介词/颗粒|所有格;|和之前的介词的粒子|所有格的|有很多。|从他们|(从)|从|它的意思|从开始，|它使所有格|名词|表观|和隐藏，|就像|它说:|最高:|(和从你|和从|Noah)(33:7)。|并且从他们|(对)|和从|它的意思|结局，|它使所有格|名词|表观|和隐藏|此外，|就像|它说:|最高:|(|给他|将传给后人|知识|小时的|)(41:47)|和它说:|(到|真主|将返回的你|all)(5:48)。|并且从他们|(从)|和从|它的意思|过剩/超越，|它使所有格|名词|表观|和隐藏|此外，|就像|它说:|最高:|(|当然|很高兴|真主|带有|believers)(48:18)|和它说:|(很高兴|真主|与他们|他们感到高兴|与他|)(5:119)。|并且从他们|(上)|和从|它的意思|以上/上，|它使所有格|名词|表观|和隐藏|此外，|就像|它说:|最高:|(和他们|和后|船舶|你是 carried)(23:22)。|并且从他们|(中)|和从|它的意思|状语/容器，|它使所有格|名词|表观|隐藏|此外，|就像|它说:|最高:|(和在|天空|是你 provision)(51:22)|和它说:|(不|其中|headache)(37:47)。|并且从他们|(一些/许多/也许)|和从|它的意思|减少/减少，|而不是|它使所有格|除了|名词|表观|无限期，|就像|你说:|(几|男士|大方|我见过)。|并且从他们|(呸)|和从|它的意思|过剩/超越/逾越，|它使所有格|名词|表观|和代词|所有的人，|就像|它说:|最高:|(是否|我们带走|与 you)(43:41)|和它说:|(去|真主|与他们的 light)(2:17)。|并且从他们|() kaf|和从|它的意思|比较，|而不是|它使所有格|除了|名词|很明显，|就像|它说:|最高:|(比喻|他的光的|就像 niche)(24:35)。|并且从他们|(林)|和从|它的意思|老有所为|和拥有，|它使所有格|名词|表观|和隐藏|此外，|就像|它说:|光荣是他|和尊贵:|(美化|向安拉|什么|在|诸天|和地球|)(57:1)，|和它说:|(为他|自治领/王国/所有权|诸天的国|和地球|)(2:107)。|并且从他们|颗粒|誓言|三|-|和他们是:|呸，|和 tah，|和 waw|-|和肯定|我们说话|在他们身上|这次演讲|详细|in|第一|书;|然后不|需要|对我们来说|到|重复|所有内容|从它。|并且从他们|waw 的|(一些/许多/也许)|和它的例子|说|Imree'|卡伊斯|很多个夜晚|是像波浪一样在悲伤中|海/深|它可以让下: 降低|其面纱窗帘|他说:|此外:|和许多美丽/贞洁/可敬|妇女的|不要|离开|家里的帐篷|并且从他们|(以来)|并且|自 (前)|和两个使所有格|两次，|和两个|该值指示|upon|含义|(从)|If|was|这其中|后两个|过去时态，|就像|(不|我看见他|逻辑 [因为]|这一天|星期四的五次)，|并且|(不|并和他在说话|对于|一个月)，|两个是|与意义|(中)|If|was|这其中|是在他们两个以后|现在时态|就像|(不|我讲给他|对于|今天)|并且|(不|我确实见过|在期间|今天一天)。|然后如果|发生|之后|(自/在/为)|或者|(自/在/为)|一个动词，|或者|was|名词|其中|在它以后|主格|然后这两个|是名词。
GreatMasterpiece75=它说:|和|这其中|使得所有格|与附件/藏建设，|然后就像|你说:|(男孩和仆人|扎伊德) 的|它是|upon|两个部分:|这其中|被暗示|与林，|和什么|被暗示|与从;|和那个的|被暗示|与林|就像|(男孩和仆人|扎伊德) 的|和那个的|被暗示|与从，|就像|(服装|丝绸)|并且|(一扇门|铁片)|并且|(环|铁)。|我说:|第部分|第二个|从|属格结构:|所有格|随着拥有/附件建设，|它是|upon|三|类，|提到|作者|从他们|两种;|第一:|这其中| Yin|与附件/藏建设|在它|upon|意义|(从)|和第二个:|这其中| Yin|附件/藏建设|在它|upon|意义|之林，|和第三个:|这其中| Yin|附件/藏建设|在它|upon|意义|(在)。|和|这其中| Yin|附件/藏建设|在它|upon|意义|(从)|然后是它的一般规则:|那| Yin|附加/拥有|部分|和一些|从|附加/拥有|到它，|就像|(长服装|羊毛)|然后当然|长服装|某些|羊毛的|和部分|从它，|和像那样|该示例|作者。|和|这其中| Yin|附件/藏建设|在它|upon|意义|(中)|然后是它的一般规则:|那| Yin|附加/拥有|到它|副词|为附加/拥有，|就像|它说:|最高:|(而是|密谋|在 night)(34:33)|然后当然|晚上|是个副词，|过夜|和时间|发生|密谋|在它。|和|这其中| Yin|附件/藏建设|在它|upon|意义|之林;|然后每个|这其中|不是|正确|在它|一|两种|所提到，|就像|(男孩和仆人|默罕默德)|并且|(在垫子上|在清真寺)。|肯定|排除在外|作者|这次演讲|upon|第部分|第三个|从|属格结构，|它是|所有格|与追随者们，|和他的借口|in|那|是他|当然|以前|说|在上面|in|最后一次|各章|nominatives|详细|和阿拉|光荣是他|和崇高|最高|他知道|赞美|和是慷慨。|问题|后|几个|种类|被划分|属格结构吗?|此培训完成后，受众能够做些什么?|意思是|其中|指示|在上面|粒子:|从|关于，|在中，|几个/很多/也许，|kaf，|林?|和什么|其中|它使所有格|每个|一|从他们吗?|生成|两个例子|从|你的创造|该名词|所有格的|与每个|一|从|颗粒/介词:|后，|呸，|对，|waw|誓言。|后|几个|种类|来自|附件/藏建设吗?|和|示例|为每个|种类|两个例子。|此培训完成后，受众能够做些什么?|是的一般规则|附件/藏建设的|其中|upon|意义|(从) 吗?|和|例子。|此培训完成后，受众能够做些什么?|是的一般规则|附件/藏建设的|其中|upon|意义|(中) 吗?|和|例子。
Maxim1=行动/事迹|取决于与他们的意图
Maxim2=确定性|不是|失效/否决|由疑问
Maxim3=困难/困难|生带来了|设施/易用性
Maxim4=危害|必须消除|(没有|应造成伤害|也不是|应得到回报的伤害)
Maxim5=自定义|确定/可作为判断的基础
Maxim6=给出了影响/值|对词，语句语音|是更好、 更适当的/优先比|忽略/忽略他们
MaximComp1=当|删除/不再存在|防喷器|returns|防止
MaximComp2=此培训完成后，受众能够做些什么?|被允许的|因为一个原因/理由|是废止会失效|与它的去除/一次它不存在
MaximComp3=当|冲突|防喷器/万向|和需要|应获优先考虑|预防/万向
MaximComp4=此培训完成后，受众能够做些什么?|被禁止|采取它|被禁止|给它
MaximComp5=此培训完成后，受众能够做些什么?|被禁止|要使用它|被禁止|保持它
MaximComp6=此培训完成后，受众能够做些什么?|被禁止|要做它|被禁止|以需求/请求它
MaximFollow1=从动件|如下
MaximFollow2=附件|非|可以/应该分离/独立|从判决
MaximFollow3=谁|拥有|东西|拥有|这其中| Yin|从的|其必需的组件
MaximFollow4=赦免被忽视|in|从动件/附件|这其中|非|可以赦免被忽视|这件事被跟随/附加
MaximFollow5=从动件|非|将去前方/得到优先/之前|upon|被跟踪的事情
MaximFollow6=If|取消变得空虚|正在跟随/附加的东西|取消变得空虚|附件/追随者|或者|附件/追随者|变得无效|与无效|正在连接后跟的事
MaximRootDeriv1=当|无效|本起源|应无效|导数/分支机构
MaximRootDeriv2=当|是无效的|东西|即属无效|这其中|in|它的里面
MaximRootDeriv3=什么被放弃|非|能恢复|就好像|那|根本不存在|非|可以恢复
MaximRootDeriv4=五月|有效期|导数|无|根
MaximRootDeriv5=当|便会作废|根|变得寻求|到|替代
MaximLiability1=产量/利润/土地/税|有 / 伴随着责任损失/补偿/保证/责任
MaximLiability2=损失的损失风险|与 / 伴随获利
MaximLiability3=轮到青睐|是按比例|坏的轮/不幸/逆境|和坏的轮/不幸/逆境|是按比例|轮到青睐
MaximLiability4=付租金|和赔偿责任|非|将合并可以一起去/可能具有包容性
MaximLiability5=允许/权限|宗教/法律|不包括勾销|赔偿责任
MaximLiability6=基本原则|in|补偿|那是|补偿|喜欢/同一件事|与它象|和有价值的东西|与它的价格
MaximLiability7=行为人/遗嘱执行人/人的行为|一经定罪，以弥补由此而造成的任何损失|即使|非|他想吗
MaximLiability8=当|收集/礼物|直接执行者/犯罪行为人的行为|和是事业的人|链接/实施|这项裁决|到|直接执行者/犯罪行为人的行为
MaximLiability9=致事/人是行为的原因|非|将补偿/法律责任作出好造成的任何损失|除非|意图
MaximLiability10=损伤/犯罪|动物的|不是责任/浪费
MaximProperty1=非|它被允许|为任何人|那|处置|in|该属性|另一个|无|在所有者同意的
MaximProperty2=叮嘱/告诉|处理/做处置|in|该属性|别人的|无效无效
MaximProperty3=非|它被允许|为任何人|那|需要|财富，财产|任何人|无|原因|法律
MaximProperty4=谁|在别人面前拥有|到|不允许|然后当然|他将会拥有它
MaximProperty5=在更改|原因|所有权的一件事|需要|位置/地点|正在更改|那件事本身
MaximCondition1=什么是依赖|上一个条件|必须是|完成|一次，当|被实现|条件
MaximCondition2=应绑定|整合|到一个条件|很远的地方作为|可能
MaximCondition3=协议或承诺|中的形状|条件/条件家属|是强制的
MaximCondition4=件事|当|很严重 /|它的位置|被视为严重考虑重要性|在它|增加|其条件
MaximCondition5=此培训完成后，受众能够做些什么?|已建立|由伊斯兰法律|是优先考虑/优先|越过|什么|已建立|由条件
MaximCondition6=每个|条件|没有这种与相反|这项裁决|伊斯兰法|是无效的
MaximOther1=简单的事|非|应放弃|由 / 困难的事情
MaximOther2=谁/什么是心事重重忙着一份工作|非|能与另一个忙
MaximOther3=连续性|更容易|于|生效日期
MaximOther4=事情应能被赦免|in|连续性|什么|非|可以赦免|in|生效日期生效日期 / 时间
MaximOther5=预防|更容易|于|取消或废除/取消/取消
MaximOther6=布置|打开|人/从属单元格的属性|是依赖于特遣队、|所得利息
MaximOther7=什么被建立|由一个证明|是那样的建立|通过查看
MaximOther8=一个人|绑定|由供状入场|/|坦白|一个人的|关于反对|他自己|被接受
MaximOther9=证据|证明|足够|和入场|证明|对别人的不足
MaximOther10=没有 / 勾销|有力的证据|带有|矛盾|but|非|使无效得到无效|与它|判断|一名法官 / 已经已通过
MaximOther11=未知|in|伊斯兰法|作为 / 当作不存在|和不可能的事|在 it/到知道
MaximOther12=将归因|操作|到|演员/实干家|非|吩咐的人|这其中|非|was|强迫
MaximOther13=非|将完成|捐赠|除了直到|与收到收据 /
MaximOther14=不具有|播种机/树/树的分支|不公正|一项权利
MaximOther15=此培训完成后，受众能够做些什么?|接近于|原创的东西|将给出|其执政
MaximOther16=什么吗|非|并得到应验|合同|除了 / 除非|通过与它| Yin|义务
MaximOther17=否|房间|对于硬派生工作/法律裁决/个体，独立的判断，基于理性的推理|在哪儿|那里是|决定性的文本
MaximOther18=努力工作/派生法律裁决/个人，基于理性推理的独立判断|非|可以失效|由其类似 / 相同
