AaminaBintiWahb=Aamina 賓薩義詞對詞
Abbasid=阿拔斯王朝字
AbdullahBinAbbas=阿卜杜拉 · 本 · 阿巴斯字
AbdullahBinAbduAlMuttalib=阿卜杜拉 · 本 · 阿卜杜 Al Muttalib 字
AbdullahBinAlZubayr=阿卜杜拉 · 本 · 基地祖拜爾字
AbdullahBinAmrBinAlAas=阿卜杜拉 Bin Amr Bin Al 原子吸收光譜字
AbdullahBinMasood=阿卜杜拉 · 本 · 馬蘇德字對字的
AbdullahBinMuhammad=阿卜杜拉 · 本 · 穆罕默德 · 字
AbdullahBinUmar=阿卜杜拉 · 本 · 歐麥爾字
Abdullah=阿卜杜拉字
AbdurRahmanBinAwf=阿卜杜勒 Rahman Bin 接替字
AbidingTherein=遵循其中字
AbooDarda=比達爾達字
AbooMoosaaAlAsharee=比窺見 Al Asharee 字
AbooZayd=比 Zayd 字
AbrogatingAndAbrogatedVerses=廢除和廢止的詩歌詞對詞
AbsoluteIdentical=絕對相同字一個字
AbsolutePredestination=絕對的緣分字
AbsoluteProximate=絕對的近似逐字逐句
AbsoluteSimilar=絕對的類似逐字逐句
AbuBakrAlSaddiqAbdullahBinAbiQuhafah=阿布 · 貝克爾 · 阿爾薩迪克阿卜杜拉 Bin Abi Quhafah 字
AbuDahr=阿布代赫爾字
AbuHurairah=孝順字
AbuJahl=阿布哲字
AbuLahab=Abu Lahab 字
AbuSufyan=阿布揚字
AbuTalib=Abu Talib 字
AbuUbaidahBinAlJarrah=Abu Ubaidah Bin 阿爾傑字對字的
Abyss=詞對詞的深淵
AcaciaTree=相思樹字
AccountReckoningQuestioning=帳戶的清算質疑字
AccusativeNounIndicatingPlaceWhereActionOccurs=行動發生詞對詞的賓格的名詞指示地方
AccusativeNounIndicatingTimeWhenActionOccurs=行動發生時詞對詞的賓格的名詞表示時間
AccusativeParticles=賓格粒子字
ActiveParticipleVerbalDoer=主動分詞口頭實幹家字
AfterBuryingTheDeceased1=後埋 Deceased1 字
AfterCallToPrayerFirstPart=O 真主|耶和華|這|通話|完成|和祈禱|我們的
AfterCallToPrayerSecondPart=給|穆罕默德|他的代禱的權利|和美德
AfterCallToPrayerThirdPart=和提高他|排名|高架|其中|你已答應他
AfterLeavingTheToilet1=我尋求你的寬恕
AfterMigrationSymbol=後遷移符號字
AfterMigration=後遷移字
AfterRainfall1=Rainfall1 字後
AishaBintAbiBakr=阿伊莎 · 賓特 · 艾布拜克爾字
AlAbbasBinAbduAlMuttalib=阿爾-阿巴斯 · 本 · 阿卜杜 Al Muttalib 字
AlAwzaai=Al Awzaai 字
AlefMaksura=Alef Maksura 字
AlefWasla=Alef Wasla 字
AlefWithHamzaAbove=Alef 隨以上字一個字喉塞音符
AlefWithHamzaBelow=Alef 隨以下字一個字喉塞音符
AlefWithMaddaAbove=Alef 隨以上字一個字 Madda
Algeria=阿爾及利亞字
AliBinAbiTalib=阿裡 Bin Abi Talib 字
AliBinHussein=阿裡 · 本 · 侯賽因字
AliBinMuhammad=阿裡 · 賓 · 穆罕默德字
AliBinMusa=阿裡 · 本 · 穆薩字
AlIstibsar=Al Istibsar 字
AllahHaveMercyOnBothOfThem=真主憐憫他們字對字的兩個
AllahHaveMercyOnHer=真主憐憫她字
AllahHaveMercyOnHim=真主憐憫他字
AllahHaveMercyOnThemFeminine=真主憐憫他們女性詞的詞
AllahHaveMercyOnThemMasculine=真主憐憫他們男性詞對詞
AllahIsGreatestAllahIsGreatest=真主是偉大真主是偉大的字
AllahIsGreatest=真主是偉大的字
AllahKnowsBest=真主知道最好的字
AllahLightHeavensAndEarth=安拉光天地字
AllahProtectionAndHelp=安拉保護和説明字
AllahProtection=安拉保護字
AllahSaysTheTruth=真主說字對字的真相
AllahSufficesMe=安拉就夠我字
AllahWilledItSo=真主的旨意所以字
AllahWilling=真主願意字
Allah=安拉字
AlLaythBinSaad=基地很有意思 · 薩德 · 字
AllowedSeparatedLengthening=允許分離延長字
AllPraiseAndThanksBeToAllahLordOfTheWorlds=所有的讚美和感謝將給世界字對字的真主魔王
AllPraiseAndThanksBeToAllah=所有的讚美和感謝全歸真主字
AllRightsReserved=擁有權利保留字的
AlMansoor=阿爾曼蘇爾字
AlMuwata=Al Muwata 字
AlOfDefiniteness=Al 的確定性字
AlSunanAlSughra=Al 蘇南基地島字一個字
AlWahsi=Al Wahsi 字
AmaarBinYaasir=奧賓亞字
AmrBinAlAas=Amr Bin Al 原子吸收光譜法字
AnasBinMaalik=阿納斯 · 本 · 馬利克字
AndAllahHasTheBestNamesCallUponHimAndLeaveThemInPlaceThoseNamesNotablyCutOffWhatTheyDo=真主具有最佳名稱呼籲他和那些名字特別是切斷他們把他們留在地方做字
AndAllahHasTheBestNamesSoCallOnThemLeaveThoseWhoPracticeDeviationConcerningHisNamesTheyWillBeRecompensedForWhatTheyHaveBeenDoing=真主有最好的名字，因此，呼籲他們離開那些實踐偏差關於他的名字，他們將會得到回報什麼他們做字一個字
AndAllahHasTheBestNamesSoCallOnThem=真主具有最佳的名字所以呼籲他們詞對詞
AndBreaksFast=和符快字
AndForParentsKindness=父母的好意字
AndHePlacedBetweenYouAffectionAndMercy=他放在你的感情和憐憫字之間
AndOfHisSignsIsThatHeCreatedForYouFromYourselvesMatesThatYouMayFindTranquillityInThem=他的標誌是他從自己的伴侶，你可能會找到安寧在他們字對字的創建為您
AndPrepareAgainstThemWhateverYouAreAbleOfPower=並準備對他們無論你是能的字對字的力量
AndUponYouBePeaceAndMercyOfAllahAndBlessings=在你身上是和平與慈悲的真主和祝福詞對詞
AndUponYouBePeaceAndMercyOfAllah=在你身上是和平與慈悲的真主字
AndUponYouBePeace=在你身上得到和平字
Antichrist=反基督者字
ArabicDictionary=阿拉伯文詞典詞對詞
Ashura=阿舒拉節字
Askaree=Askaree 字
AskingForClearSkies1=要求明確 Skies1 字
AssimilateGreatIdentical=吸收大相同字
AssimilateLaamSunLetter=同化 Laam 太陽字母詞的詞
AssimilateSmallIdentical=同化小相同字一個字
AssimilateSmallProximate=同化小近字一個字
AssimilateSmallSimilar=同化小類似字一個字
Astray=字迷了路
AttachedPronouns=連接的代詞字
AtTheStartOfPrayer1=O 真主，|個別|我|從|我的罪|作為|你已經分居||東方|從西方國家。|O 真主，|潔淨我|/|我的過犯|作為|潔淨|服裝|白色|/|污漬。|O 真主，|清洗|離開|我的罪|加冰|和水|和霜凍。
AtTheStartOfPrayer2=榮耀是給你，|O 真主，|和讚美，|是有福的|姓名|和崇高|是陛下，|沒有|值得一的崇拜|但你。
AtTheStartOfPrayer3=我轉|我的臉|對一個人|建立時間|諸天|和地球，|作為一個忠實的信徒。|非|我是|那些|誰將關聯以物配主的夥伴。|實在，|我的祈禱|和我的熱情，|我的生活|和我的死亡，|是為真主，|耶和華|世界，|否|合作夥伴|有他。|因此|我已吩咐|和我|其中誰|已提交。|O 真主，|您|是國王，|沒有|值得一的崇拜|但|你。|您|是我的主|和我|你的奴隸。|我冤枉了|我自己的靈魂|承認|我的罪孽。|原諒|我為|我的罪|所有的|肯定|none|原諒|罪|但|你。|引導說明|對完善|我的角色，|沒有一個|指南|對及其完善|但|你。|保護|我從|邪惡的我的性格，|沒有一個|可保護|我從|其罪惡|但|你。|我在這裡|在您的服務。|善良|全部|在你的手，|與邪惡|不歸因於|給你。|I|上午由您 (創建)|和我我給你 (返回)。|你是最幸福的|最尊貴。|我尋求你的寬恕|並要悔改行|給你。
AtTheStartOfPrayer4=O 真主，|耶和華|Jibra'il，|Mika'il|和 Israfil。|製造商|諸天|和地球。|知者的|看不見的|與所見。|您|法官|介於|你的奴隸|那|關於|在其中|他們不同。|引導說明|對那|還有的區別關於|在其中|從|真相，|由你的離開。|當然，|你的指南||你請誰|到|直道|路徑。
AtTheStartOfPrayer5=真主|是最了不起的|最偉大。|真主|是最了不起的|最偉大。|真主|是最了不起的|最偉大。|稱讚|是向安拉，|豐富。|稱讚|是向安拉，|豐富。|稱讚|是向安拉，|豐富。|榮耀|是向安拉，|在破碎的一天|和在它的末端。|(3) x|我尋求庇護|在安拉|從|撒旦，|來自|他的呼吸|從他的聲音|從他的耳語。
AtTheStartOfPrayer6=O 真主，|對你來說是|讚美。|您|是的光|諸天的國|和地球|和這一切|它們包含。|對你來說是|讚美，|您|是維繫者|諸天的國|和地球|和所有|它們包含。|(對你而言是|讚美，|您|是耶和華|諸天的國|和地球|和所有|他們包含)。|(對你而言是|讚美，|您的變更|是統治|諸天的國|和地球|和所有|他們包含)。|(對你而言是|讚美，|您|是王|諸天的國|和地球)。|(和你是|讚美)。|(你|都是實話，|你的諾言|是真實的|你的話語|是真實的|你的聽眾|是真實的|天堂|是真實的|地獄|是真實的|先知|是真實的|和穆罕默德 (願主)|是真實的|小時的判斷|是真的)。|(O 真主，|給你|我已經提交，|和在你身上|我信賴。|在你|我一直相信|和你|我把在悔過。|為你的緣故|我爭議|以你的標準|我判斷。|原諒|我|什麼|我把在我面前|和什麼|我在我身後，讓|什麼|我隱瞞|和什麼|我宣佈。)|(你|有一個人發出|和你|一位延遲|沒有|誰有權來敬拜|但|你的)。|(你|是我的神，|沒有|誰有權來敬拜|但|你的)。
Attributes=屬性詞對詞
Audible=詞對詞的聲音
AzZubayrbinAlAwam=Az Zubayrbin Al 坦字
Baaqir=Baaqir 字
BaniHashim=巴尼 Hashim 字
BaniMakhzoom=巴尼 Makhzoom 字
BaniThaqeef=巴尼 Thaqeef 字
BasisOfTransmissionOfLanguage=傳播的語言詞對詞的基礎
Bed=床上字
BeforeEating2=前 Eating2 字
BeforeEating3=前 Eating3 字
BeforeEating4=前 Eating4 字
BeforeEnteringTheToilet1=(然後)O 真主|I|尋求保護|在你|從|男性的邪魔|和女性的邪魔
BeforeGivingPeaceOfPrayer10=之前給 Prayer10 字對字的和平
BeforeGivingPeaceOfPrayer11=之前給 Prayer11 字對字的和平
BeforeGivingPeaceOfPrayer1=之前給 Prayer1 字對字的和平
BeforeGivingPeaceOfPrayer2=之前給 Prayer2 字對字的和平
BeforeGivingPeaceOfPrayer3=之前給 Prayer3 字對字的和平
BeforeGivingPeaceOfPrayer4=之前給 Prayer4 字對字的和平
BeforeGivingPeaceOfPrayer5=之前給 Prayer5 字對字的和平
BeforeGivingPeaceOfPrayer6=之前給 Prayer6 字對字的和平
BeforeGivingPeaceOfPrayer7=之前給 Prayer7 字對字的和平
BeforeGivingPeaceOfPrayer8=之前給 Prayer8 字對字的和平
BeforeGivingPeaceOfPrayer9=之前給 Prayer9 字對字的和平
BeforeSexualIntercourse1=前性 Intercourse1 字
BeforeTravel=我特此離開你|真主確|與這種宗教|和什麼|責任|和以前|契據
BetweenTwoProstrations1=兩個 Prostrations1 字之間
BetweenTwoProstrations2=兩個 Prostrations2 字之間
BeWithAllah=是以物配主詞的詞
BirthdayOfTheProphet=字對字的先知的生日
BitterObnoxiousThornyPlant=苦味道令人討厭的棘手植物詞對詞
BlazingFlame=熊熊火焰字
BlessedAndExaltedBeHe=祝福和崇高被他字
BlessedFeastCelebration=福的宴慶祝詞對詞
BlessedMecca=有福的麥加字
BlessingsOfAllahUponBothOfThem=真主的祝福他們字對字的兩個
BlessingsOfAllahUponHer=真主的祝福她字
BlessingsOfAllahUponHim=真主的祝福他字
BlessingsOfAllahUponThemFeminine=真主的祝福詞對詞的女性
BlessingsOfAllahUponThemMasculine=真主的祝福陽性詞對詞
BlessingsOfAllah=真主字對字的祝福
BoilingOil=沸油字
BoilingWater=沸騰的水字
BridleIt=韁繩字
BrokenPlural=破碎的複數詞對詞
BrokenToPieces=碎了詞的詞
CallToBeginPrayerSixthVerse=事實上|已開始|禱告
CallToPrayerEighthVerse=有沒有|神|除了|真主
CallToPrayerFifthVerse=來吧|到|成功
CallToPrayerFourthVerse=來吧|到|禱告
CallToPrayerSecondVerse=我作證|那|有沒有|神|除了|真主
CallToPrayerSeventhVerse=真主是|最大
CallToPrayerSixthVerse=禱告是|更好|於|睡眠
CallToPrayerThirdVerse=我作證|那|穆罕默德是|信使|真主
CaveOfHira=Hira 詞對詞的洞穴
Celebration1=Celebration1 字
Celebration2=Celebration2 字
CentralTreasury=中央財政部字
CharacterDoubled=增加了一倍字對字的字元
ChestInterior=胸部內政字
China=中國字
ClassicArabic=經典阿拉伯文詞對詞
ClearLaamMoonLetter=清除 Laam 月亮信字
Closing=關閉字
Cohabitation=同居字
CollectiveObligation=詞對詞的集體義務
Colon=結腸字
ComeToPrayer=禱告詞對詞的來到
ComeToSuccess=來到成功字
CommandTenseVerb=命令緊張動詞詞對詞
CommentaryByContemplation=沉思字對字的評論音軌
ComparativeDerivedNoun=比較派生名詞字
ConditionDenotedByConditionParticle=由條件粒子字表示的條件
ConditionOfOath=宣誓詞對詞的條件
Condolence1=Condolence1 字
ConnectedLengtheningEssential=連接延長基本詞對詞
ConnectedPronoun=連接的代詞字
ConnectingParticles=連接詞對詞的粒子
ConsensusOfThePeopleOfMedina=梅迪納字對字的人的共識
ContradictoryDifferences=矛盾差異字
Cover=蓋字
CreedOfIslamFirstPart=伊斯蘭教第一部分詞對詞的信條
CreedOfIslamSecondPart=伊斯蘭教第二部分詞對詞的信條
CreedOfIslam=信仰伊斯蘭教字
DailyPredestination=每日緣分字
Dammatan=Dammatan 字
DayOfWeek1=Week1 字對字的一天
DayOfWeek2=Week2 字對字的一天
DayOfWeek3=Week3 字對字的一天
DayOfWeek4=Week4 字對字的一天
DayOfWeek5=Week5 字對字的一天
DayOfWeek6=Week6 字對字的一天
DayOfWeek7=Week7 字對字的一天
DeclarationWhenSittingInPrayer1=申報書時坐在 Prayer1 字
DeductionByResemblance=由相似詞對詞的扣除
Definiteness=確定性字
Definite=確切的消息，由詞
DeputyDoer=副實幹家字
DerivedIntensiveAdjectivesIntransitive=派生的密集形容詞迷字
DerivedNouns=派生的名詞字
DerivedSuperlativeAdjectivesTransitive=派生的比較級形容詞動詞詞對詞
DescribingConstruction=描述建設字
DesperateOddPrayer1=絕望的奇數 Prayer1 字
DesperateOddPrayer2=絕望的奇數 Prayer2 字
DesperateOddPrayer3=絕望的奇數 Prayer3 字
DetachedPronouns=超然的代詞字
DetachedPronoun=超然的代詞字
Diffusion=擴散字
DirectObjectOfVerb=直接賓語的動詞詞對詞
DisbeliefOfActs=不相信的字對字的行為
DisbeliefOfHeart=不相信的心字
DisbelievingPeople=懷疑人字
Discord=不字對字的和諧
DisjointedLetters=脫節的字母詞的詞
Distanced=遠距離的字一個字
DistinctionLengthening=區分延長字
Divinity=神字
DivorcedWomen=離婚的婦女字
DoctrineOfUnityOfExistence=統一的詞對詞的存在學說
DoctrineTheologyPrincipleOfBelief=字對字的信仰主義神學原則
Dragging=拖字
Dusk=黃昏詞對詞
Ease=易用性詞的詞
Eighth=第八字
Elevation=高程字
Elisha=以利沙字
Elongation=斷裂伸長率字
Embarass=Embarass 字
Emigrants=移民字
Emirates=阿聯酋字
EmptyHamza=空喉塞音符詞對詞
EnlightenedMedina=開明的麥迪那字
EnteringMasjidilHaram=O 真主|禰|和平|和從你|和平|導致我們生活|我們的主|與和平|導致我們進入|天堂|這房子|和平|擁有者的榮譽|我們的主|和陛下|禰|最幸福|和崇高|O 真主|授予|我|含有|你的祝福|和寬恕|和我住|在它|量的名稱|真主|和所有的稱讚是到|真主|salawat|和薩拉姆|到我們|信使|真主|稱呼|真主|在他身上|與和平
EnteringMosque=進入清真寺字
EnterItWithPeaceAndSafety=輸入與和平與安全詞對詞
EssenceOfTheBook=字對字的這本書的精華
EssentiallyPossessiveConstruction=本質上是佔有欲建設字
EstablishCharity=建立慈善字
EstablishPrayer=建立禱告詞對詞
Ethics=倫理字
ExcellenceOfRemembranceAndGlorificationOfAllah10=卓越的紀念和歌頌 Allah10 字
ExcellenceOfRemembranceAndGlorificationOfAllah11=卓越的紀念和歌頌 Allah11 字
ExcellenceOfRemembranceAndGlorificationOfAllah12=卓越的紀念和歌頌 Allah12 字
ExcellenceOfRemembranceAndGlorificationOfAllah13=卓越的紀念和歌頌 Allah13 字
ExcellenceOfRemembranceAndGlorificationOfAllah14=卓越的紀念和歌頌 Allah14 字
ExcellenceOfRemembranceAndGlorificationOfAllah1=卓越的紀念和歌頌 Allah1 字
ExcellenceOfRemembranceAndGlorificationOfAllah2=卓越的紀念和歌頌 Allah2 字
ExcellenceOfRemembranceAndGlorificationOfAllah5=卓越的紀念和歌頌 Allah5 字
ExcellenceOfRemembranceAndGlorificationOfAllah6=卓越的紀念和歌頌 Allah6 字
ExcellenceOfRemembranceAndGlorificationOfAllah8=卓越的紀念和歌頌 Allah8 字
ExcellenceOfRemembranceAndGlorificationOfAllah9=卓越的紀念和歌頌 Allah9 字
ExchangeLengthening=交換延長字
ExclamationMark=驚嘆號字
Ezekiel=以西結書字
FairLadiesOfTheRiver=公平的女士們的字對字的河
FamiliarOpinionBasedExegesis=熟悉的意見以訓詁詞對詞
FarPointingNouns=遠指詞對詞名詞
FarthestMosque=最遠清真寺字
Far=遠字
FastBreakingCharity=很快，結果打破慈善字
Fathatan=Fathatan 字
FatimaBintiAmr=法蒂瑪 · 賓 Amr 字
FatimaBintiMuhammad=法蒂瑪 · 賓穆罕默德字
Fatimid=法蒂瑪王朝字
FearAllah=你們當敬畏真主字
Feminine=女性詞的詞
FestivalOfBreakingFast=節日的打破快字
FestivalOfSacrifice=獻祭詞對詞的節日
FifthCreed=我尋求寬恕|從真主|我的主|從|每|sin|我犯了|知情的情況下|或|unknowningly|偷偷地|或|公開|和我轉向|他|從|罪|那|我知道|和從|罪|那|非|我知道|當然|你是|知者|隱藏的東西|和遮瑕膏|所犯的錯誤|和寬恕|罪得赦免|和沒有|可能|和沒有|強度|除了|以物配主|最高|最壯麗
Final1=其中|非|他是這樣的|東西|他是|聽話人|先見
Final2=O 真主|傳送|最好的|禱告|後|最佳|你們的創造物|母片|默罕默德
Final3=與和平|訴說著|他的知識|和油墨|他話裡的|每當|記得他|這樣做|當那些人忽視|到|記得他|這樣做
FireInferno=地獄火字
FirstCreed=有沒有|神|除了|真主|默罕默德|Messenger|真主
FirstFamilyRootVerb=第一家庭根動詞詞對詞
FirstPersonAttachedPronoun=第一人稱附加詞對詞代詞
FirstPersonSingularVerbalAttachedPronoun=第一人稱單數語言附加詞對詞代詞
FiveSpecialNouns=五個特殊名詞字
FixedInTheBookAndTradition=在這本書和傳統字對字的固定
Fluency=流利的字
FollowerOfFollowers=追隨者字對字的追隨者
ForAnxietyAndSorrow1=焦慮和 Sorrow1 字
ForAnxietyAndSorrow2=O 真主，||我尋求庇護|在你|從|悲傷|和悲傷，|從弱點|和從懶惰，|從吝嗇|和從懦弱，|從被克服|由債務|和制服|男人們 (即其他人)。
ForbiddanceOfAscribingThingsToOmens1=鎖止的把事情歸咎于 Omens1 字
ForbiddenUponYouTheDeadAnimal=禁止在你身上死動物詞的詞
ForConcludingAllSittings1=為結束所有 Sittings1 字
ForExpiationOfSinsAtTheConclusionOfSittingOrGathering1=榮耀是給你|O 真主|和好評|我可以作證|那|沒有|值得一的崇拜|但|您|我尋求你的寬恕|和悔改的|給你
ForExpiationOfSinsAtTheConclusionOfSittingOrGathering2=為在結束時，或坐或 Gathering2 詞對詞的罪贖罪
ForFearOfShirk1=由於 Shirk1 字對字的擔心
FormlessMetaphor=無形的隱喻詞對詞
ForOneAfflictedWithDoubtInFaith2=一個患 Faith2 字對字的懷疑
ForOneInDistress1=一 Distress1 字
ForOneInDistress2=一 Distress2 字
ForOneInDistress4=一 Distress4 字
ForOneWhoseAffairsHaveBecomeDifficult1=對於一個其事務已成為 Difficult1 字對字的
ForRain1=為 Rain1 字
ForRain2=為 Rain2 字
ForRain3=為 Rain3 字
ForSeekingGuidance1=為尋求 Guidance1 字
ForTheAdvancementOfRewardDuringTheFuneralPrayer1=為獎勵在葬禮 Prayer1 字對字的地位
ForTheDeceasedAtFuneralPrayer1=為在葬禮 Prayer1 字對字的死者
ForTheDeceasedAtFuneralPrayer2=為在葬禮 Prayer2 字對字的死者
ForTheDeceasedAtFuneralPrayer3=為在葬禮 Prayer3 字對字的死者
ForTheDeceasedAtFuneralPrayer4=為在葬禮 Prayer4 字對字的死者
ForTheOneYouHaveInsulted1=對於一個你有 Insulted1 字
ForTravel1=為 Travel1 字
FoulNourishmentPusDischarge=犯規營養膿放電字
FourLetterRootVerb=四個字母的動詞詞根詞對詞
FourthCreed=有沒有|神|除了|真主|孤獨|否|夥伴|有他|對他來說|聯合王國|和他|稱讚|他給生活|和帶來的死亡|他是|過生活|非|有能力的死亡|永不|曾經|佔有人|威嚴的|與崇敬|在他的手|善良|他是|後|全部|事情|功能強大
FundamentalPrinciplesOfQuranicInterpretation=古蘭經 》 解釋詞對詞的基本原則
GateOfCharity=門的慈善字
GateOfFaith=詞對詞的信仰之門
GateOfFasting=門的空腹字
GateOfJihad=字對字的聖戰之門
GateOfPilgrimage=門的朝聖字
GateOfPrayer=禱告詞對詞的大門
GateOfRemembrance=紀念詞對詞的大門
GateOfRighteousnessToParents=門的義詞對詞的父母
GateOfWithholdingAngerAndForgivness=門的扣繳憤怒和詞對詞的原諒
Gathering=收集字
Gender=性別字
GenericNounInPossessiveConstructionWithDefiniteNounOrPronoun=通用名詞所有格建設與明確的名詞或代詞字
GloriousAllahWilling=光榮的真主願意字
GloriousAndExaltedBeHe=光榮和崇高，必字
GloryBeToAllah=榮耀歸於真主字
GloryBeToYouAllah=榮耀歸於真主字
GogAndMagog=歌革和瑪各詞的詞
GrandWord=大詞字
GreatBounce=大反彈字
GreatProximate=偉大的近似詞的詞
GreatSimilar=偉大的類似逐字逐句
GreatWithPraiseToAllah=偉大真主字對字的頌贊
GroomOnWeddingNightOrWhenBuyingAnimal1=在新婚之夜新郎或當購買 Animal1 詞的詞
Group=組字
HadithQudsi=庫德西聖訓字
HadithSciences=聖訓科學字
Hadi=哈迪字
HafsaBintUmar=歐麥爾茲 · 賓特 · 字
HamzaBinAbduAlMuttalib=哈姆紮 · 本 · 阿卜杜 Al Muttalib 字
HappyFeastCelebration=幸福快樂的元宵節慶祝詞對詞
HarmOfTheEye=詞的詞眼的危害
HasanAskariBinAli=哈桑阿斯卡裡本 · 阿裡字
HasanBinAli=哈桑 · 本 · 阿裡字
Hasan=哈桑字
HeartSofteners=純潔性字
Heaven=天堂詞對詞
HeIsAllah=他是真主字
HiddenMetaphor=隱藏的隱喻詞對詞
HigherVerbFamiliesDerivedFromFirstFamily=較高的動詞家庭來自第一家庭字
HindBintAbiUmayya=Abi 倭馬亞後腿 · 賓特 · 字
HolyHouse=聖潔的房子字
HorribleTreeOfHell=可怕的地獄字對字的樹
HotFoodGreaseSweat=熱的食物潤滑脂汗字
HowTheProphetMadeTasbeeh1=如何先知作 Tasbeeh1 字
Hudabiyyah=Hudabiyyah 字
HusseinBinAli=侯賽因 · 本 · 阿裡字
Hussein=侯賽因字
IAskAllahForgiveness=我請求真主寬恕字
IHavePutTrustInAllah=我倚靠在安拉字
IhramPrayerSupplication=量的名稱|真主|最親切|最仁慈|真主|是最大的|真主|是最大的|真主|是最大的|如何完美|他是|一位已放置|這 (運輸)|而不是|我們自己|，|本來能夠|和真正|到|我們的主|是我們最後的命運|O 真主|真正|我們對你的要求|於|旅行|此|比爾|和 taqwaa|和|事蹟|其中|請你|O 真主|說明|便利|我們的旅程|此|讓我們覆蓋它的距離|真正|快速|O 真主|你是|同伴|在|旅程|及後繼者|過度|家庭|O 真主|I|帶你的避難所|從|困難|傳導|和有變化的心|在一個糟糕的困境|和出來|很倒楣|含有|財富|和家人
ImamAbuHanifa=伊瑪目艾布哈尼法字
ImamAlLayth=伊瑪目 Al Layth 字
ImamAthThawri=伊瑪目 Ath 掃蕾字
ImamAtTabari=伊瑪目在泰伯字
ImamAwzaee=伊瑪目 Awzaee 字
ImamBukhari=伊曼字
ImamDawood=達烏德 • 伊瑪目字
ImamHanbal=伊瑪目罕字
ImamMalik=伊瑪目馬利克字
ImamMuhammadTaqi=伊瑪目穆罕默德 Taqi 字
ImamMuslim=伊瑪目穆斯林字
ImamNawawi40Hadith=伊瑪目 Nawawi40 聖訓字
ImamShafiee=伊瑪目 Shafiee 字
ImamZayd=伊瑪目宰字
ImmediatelyFollowingDeclarationOfFaithInCallToPrayer1=I|見證|那|none|有權受崇拜|但|真主|獨自一人，|否|夥伴|有他，|和那|默罕默德|是他的奴隸|和他的使者。|我很高興|以物配主|作為我的主，|與默罕默德|作為我的信使|和伊斯蘭教的教義|作為我的信仰。
InBetweenRecitation=在朗誦詞對詞
InclinationDrifting=傾角漂流字
IndefiniteInNegativeOrProhibitiveConstruction=在消極或禁止建設字對字的無限期
India=印度字
IndicationOfMeaningByNecessarySupposition=通過必要的假設詞對詞的意義的徵兆
IndicationOfMeaningBySuggestion=由建議詞對詞的意義的徵兆
IndirectObject=間接賓語字
IndividualObligation=個人義務字
InProtectionOfAllah=在安拉詞對詞的保護
InRemembranceOfAllahHeartsFindPeace=在紀念安拉的心找到和平字
InShort=總之字
InstructionForOneAfflictedByCalamity1=一個受 Calamity1 字對字的指令
InstrumentOfAction=行動詞對詞的手段
IntenselyHotWind=熾熱的風字
IntentionForIhramPrayer=我提供|建議|受戒禱告|兩個專用|真主確|最高
IntentionForIhramShower=我打算|洗澡|建議|受戒淋浴|真主確|最高
IntentionForJourneyPrayer=我提供|建議|薩法爾 · 祈禱|兩個專用|真主確|最高
IntentionForJourneyShower=我打算|洗澡|Musafir 淋浴|建議|真主確|最高
IntentionToPerformUmrah=我打算|副朝|和受戒|只是|真主確|最高
Intercession=代禱詞對詞
InterestFreeLoan=免息貸款字
InTheEvening1=我們已經結束了新的一天|和與它|所有的統治|是真主的。|稱讚|是對阿拉。|無|有權受崇拜|但|真主|獨自一人，|否|夥伴|有他。|向安拉|國權，|對他|是讚美|他是|後|全部|事情|能做到。|我的主，|我問你|美好的事物||/|此|深夜|RD|來的夜晚|在它之後，|我尋求庇護|在你|從|邪惡||/|此|深夜|RD|來的夜晚|在它以後。|我的主，|我尋求庇護|在你|從|懶惰|和無助|年老了。|我的主，|我尋求庇護|在你|從|處罰|/|地獄之火，|和從處罰|/|墳墓。
InTheEvening2=O 真主，|您|給我們帶來年底的一天|作為你|給我們帶來它的起點，|您|帶給我們的生活|和你|給我們帶來死亡，|和你|是我們的命運。
InTheEvening3=O 真主，||我有另一天結束|並呼籲你|和後|承擔者|你的寶座，|在你的天使|和所有|創作|為見證，肯定|您|是真主，|沒有|值得一的崇拜|但|您|獨自一人，|否|合作夥伴|你有，|和那|默罕默德|是你的奴隸|和你的信使。
InTheEvening4=O 真主，|作為|我進入這個晚上||無論|祝福一直以來深受我|或|任何人|/|你的創造|是從你|獨自一人，|否|夥伴|你有。|給你的|一切讚頌|和你|是表示感謝。
InTheEvening5=我們已經結束了新的一天|和與它|所有統治|其中屬於真主，|耶和華|所有的存在。|O 真主，||我問你|美好的事物|這|晚上，|它的勝利，|它的説明，|它的光芒，|它的祝福，|和它的教導。|我尋求庇護|在你|從|邪惡|那是|在它|和從邪惡|那|跟隨它。
InTheEvening6=我們結束這一天|後|自然宗教|伊斯蘭教，||這個詞|真誠奉獻，||宗教|我們的先知|穆罕默德 (願主的真主)，|RD|信心|我們的父親|易卜拉欣。|他是正直 (在敬拜安拉)，|和一位穆斯林。|非|他是|那些|除真主外的其他人崇拜誰。
InTheEvening7=我尋求庇護|換句話說|真主|完美|從|邪惡|什麼|他創造了。
InTheEvening8=我們已經今天晚上|RD|主權是所有|阿拉 s。|讚美是|獨自一人，安拉|否|夥伴|他有，|有沒有|神|但|他，|賜給他們|是我們的命運。
InTheEvening9=O 真主!||在晚上，我站起來|含有|你有賜予我的所有的一切都|祝福，|強度，|和保護。|完整安裝|你的祝福，|(你賜予我)|強度|和你的保護，|於|這種生活|和來世。
InTheMorning1=我們已經進入了新的一天|和與它|所有的統治|是真主的。|稱讚|是對阿拉。|無|有權受崇拜|但|真主|獨自一人，|否|夥伴|有他。|向安拉|國權，|對他|是讚美|他是|後|全部|事情|能做到。|我的主，|我問你|善良||/|此|天|RD|來的日子|在它之後，|我尋求庇護|在你|從|邪惡||/|此|天|RD|來的日子|在它以後。|我的主，|我尋求庇護|在你|從|懶惰|和無助|年老了。|我的主，|我尋求庇護|在你|從|處罰|/|地獄之火，|和從處罰|/|墳墓。
InTheMorning2=O 真主，|由你|我們輸入的早晨|和你|我們進入了晚上，|由你|我們的生活|和你|我們死了，|和你|是最後返回。
InTheMorning3=O 真主，||已經進入了一個嶄新的早晨|並呼籲你|和後|承擔者|你的寶座，|在你的天使|和所有|創作|為見證，肯定|您|是真主，|沒有|值得一的崇拜|但|您|獨自一人，|否|合作夥伴|你有，|和那|默罕默德|是你的奴隸|和你的信使。
InTheMorning4=O 真主，|作為|我輸入今||無論|祝福一直以來深受我|或|任何人|/|你的創造|是從你|獨自一人，|否|夥伴|你有。|給你的|一切讚頌|和你|是表示感謝。
InTheMorning5=我們已經進入了新的一天|和與它|所有統治|其中屬於真主，|耶和華|所有的存在。|O 真主，||我問你|善良|這|一天，|它的勝利，|它的説明，|它的光芒，|它的祝福，|和它的教導。|我尋求庇護|在你|從|邪惡|那是|在它|和從邪惡|那|跟隨它。
InTheMorning6=我們已經進入了新的一天|後|自然宗教|伊斯蘭教，||這個詞|真誠奉獻，||宗教|我們的先知|穆罕默德 (願主的真主)，|RD|信心|我們的父親|易卜拉欣。|他是正直 (在敬拜安拉)，|和一位穆斯林。|非|他是|那些|除真主外的其他人崇拜誰。
InTheMorning7=榮耀|是對阿拉|讚美是給他，|由眾多|他創作的|由快樂，|他|按重量計|他的寶座，|和多大程度上|他的話。
InTheMorning8=我們已經今|RD|主權是所有|阿拉 s。|讚美是|獨自一人，安拉|否|夥伴|他有，|有沒有|神|但|他，|賜給他們|是的回報。
InTheMorning9=O 真主!||清晨，我站起來|含有|你有賜予我的所有的一切都|祝福，|強度，|和保護。|完整安裝|你的祝福，|(你賜予我)|強度|和你的保護，|於|這種生活|和來世。
InTheMorningOrEvening10=在早上或 Evening10 字
InTheMorningOrEvening11=在早上或 Evening11 字
InTheMorningOrEvening12=在早上或 Evening12 字
InTheMorningOrEvening13=在早上或 Evening13 字
InTheMorningOrEvening3=O 真主，|您|是我的主，|沒有|值得一的崇拜|但|你。|你創造了我|和我|你的奴隸。|I|保留|你的約，|和我對你的承諾|只要|我能，|我尋求庇護|在你|從|邪惡|什麼|我做了，|我承認|到|你的祝福|在我身上，|我承認|我的罪行。|原諒|我，|持續|沒有|誰可以原諒|罪|但|你。
InTheMorningOrEvening4=O 真主，|使我健康|於|我的身體。|O 真主，|保留|對我來說|我的聽力。|O 真主，|保留|對我來說|我的視線。|沒有|值得一的崇拜|但|你。|(在阿拉伯文背誦三倍)。|O 真主，||我尋求庇護|在你|從|不敢相信|與貧困|我尋求庇護|在你|從|處罰|墳墓。|沒有|值得一的崇拜|但|你。
InTheMorningOrEvening6=在早上或 Evening6 字
InTheMorningOrEvening7=在早上或 Evening7 字
InTheMorningOrEvening8=在名稱中|真主，|誰|非|會造成傷害。|含有|他的名字|任何檔案|於|地球|也不是|於|天哪，|他是|全聽，|全知。
InTheMorningOrEvening9=在早上或 Evening9 字
InTheNameOfAllahMostBeneficentMostMerciful=真主最仁慈最仁慈逐字逐句的名義
InTheNameOfAllah=以字對字的真主的名義
InThePathOfAllah=在安拉詞對詞的路徑
IntransitiveVerb=不及物動詞詞對詞
IntroductionBestNames=我們問你|O，|他|安拉是|誰|有沒有|神|除了|他
IntroductionFirst=實在|所有的讚美|是為真主，|我們稱讚他，|並尋求他的説明和指導|和他的寬恕;|我們尋求庇護|在安拉|從|邪惡|我們自己|和從|有罪|我們的行動。|凡|指南|真主|然後無|可以誤導|他，|凡|安拉誤導|可以有沒有|輔助線|為他。|和我作證|那|有沒有|值得崇拜的神|除了|真主|孤獨|否|夥伴|有他，|和我作證|那|默罕默德|是他的僕人|和信使。
IntroductionSecond=到|繼續:|當然|最好的|語音|是這本書|真主|優秀|指引|是指導|穆罕默德的|祈禱|真主|在他身上|與和平。|最邪惡|事件|是宗教的新發明的問題|和每個|新發明的事|是創新|和每個|創新|已偏離|和每個|偏離|在其中|火。
InvocationAfterDeclarationWhenSittingInPrayer1=當坐在 Prayer1 字對字的聲明後調用
InvocationAfterDeclarationWhenSittingInPrayer2=當坐在 Prayer2 字對字的聲明後調用
Iraq=伊拉克字
IslamicDisciplines=伊斯蘭學科字
IslamicNewYear=伊斯蘭新年字
IsraAndMiraj=伊斯拉和 Miraj 字
ISwearByAllah1=我起誓 Allah1 字
ISwearByAllah2=我起誓 Allah2 字
ISwearByAllah3=我起誓 Allah3 字
ISwearByAllah4=我起誓 Allah4 字
JaabirBinAbdullah=賈比爾 · 本 · 阿卜杜拉字
JafarBinAbiTalib=賈法爾 Bin Abi Talib 字
JafarBinMuhammad=賈法 · 本 · 穆罕默德 · 字
Jawaad=Jawaad 字
JesusSonOfMary=瑪麗詞對詞的兒子耶穌
Jordan=Jordan 字
JuwayriyaBintAlHarith=Juwayriya Bint Al 哈裡斯字
Kadhim=卡迪姆字
Kasratan=Kasratan 字
KhadijahBintKhuwaylid=赫蒂傑 · 賓特 · Khuwaylid 字
KhalidBinWalid=哈立德 · 本 · 瓦利德字
Khawarij=Khawarij 字
Kinship=親屬詞的詞
KitabAlKafi=塔布鋁卡菲字
Kuwait=科威特字
LaamHeaviness=Laam 沉重字
LaamLightness=Laam 輕盈字
LaamOfEmphasis=Laam 重點詞對詞
LaamParticle=Laam 粒子字
LaamVerb=Laam 動詞詞對詞
LeftCurlyBracket=左花括弧字
LeftPointingDoubleAngleQuotationMark=左指雙尖引號字
LeftSquareBracket=字的左方括弧
LegalMethodologyFundamentalPrinciplesOfIslamicLaw=法學方法論伊斯蘭法律詞對詞的基本原則
Legislation=立法字
LegislativePrescription=立法處方字
LengtheningPresentedToSukoon=延長提交 Sukoon 字一個字
LifePredestination=生活緣分字
LightenedCompulsoryLengtheningLetters=減輕的義務教育延長字母詞的詞
LightenedCompulsoryLengtheningWords=減輕的義務教育延長字對字的單詞
LightOfTheHeavensAndEarth=天堂和地球詞對詞的光
LinguisticMetaphorMetonymy=語言隱喻轉喻詞對詞
LiteralExegesis=文字訓詁詞對詞
LoteTree=Lote 樹字
LotusTree=蓮花樹字
Lowering=降低字
LowerSelf=詞對詞的較低自我
MadeAgainstAnEnemy1=針對 Enemy1 作出字
MajorAssociation=主要關聯詞的詞
MajorIncorrectPronunciation=主要的不正確的發音詞對詞
MajorPolythiesm=主要多神論詞的詞
Mankind=人類字
ManLaYahduruhuAlFaqih=人 La Yahduruhu Al 法基字
MannersOfDiffering=不同詞對詞的舉止
Manners=詞對詞的舉止
MariaAlQibtiyya=瑪麗亞 Al Qibtiyya 字
Masculine=男性詞對詞
MayAllahAcceptFromUsAndFromYou=可能安拉接受來自我們和您字對字的嗎
MayAllahAcceptYourEffort=安拉可能接受你的努力字對字的嗎
MayAllahBePleasedWithBothOfThem=願安拉喜悅他們字對字的兩個嗎
MayAllahBePleasedWithHer=願安拉喜悅她字對字的嗎
MayAllahBePleasedWithHim=願安拉喜悅他字對字的嗎
MayAllahBePleasedWithThemFeminine=願安拉喜悅他們女性詞的詞
MayAllahBePleasedWithThemMasculine=願安拉喜悅他們男性詞對詞
MayAllahBlessYou=願真主保佑你字對字的嗎
MayAllahContinuouslyShowerBlessingsUponBothOfThem=安拉可能不斷沐浴著兩人詞對詞的祝福嗎
MayAllahContinuouslyShowerBlessingsUponHer=安拉可能不斷沐浴著她逐字逐句的祝福嗎
MayAllahContinuouslyShowerBlessingsUponHim=安拉可能不斷沐浴著他逐字逐句的祝福嗎
MayAllahContinuouslyShowerBlessingsUponThemFeminine=可能真主不斷的祝福在他們身上女性詞對詞嗎
MayAllahContinuouslyShowerBlessingsUponThemMasculine=可能真主不斷的祝福在他們身上男性詞對詞嗎
MayAllahHaveMercyOnBothOfThem=願真主慈憫上兩人詞的詞嗎
MayAllahHaveMercyOnHer=願真主慈憫她字對字的嗎
MayAllahHaveMercyOnHim=願真主慈憫他字對字的嗎
MayAllahHaveMercyOnThemFeminine=願真主慈憫他們女性詞對詞嗎
MayAllahHaveMercyOnThemMasculine=願真主慈憫他們男性詞對詞嗎
MayAllahKeepBothOfThemWell=願安拉使他們兩個字好嗎
MayAllahKeepHerWell=願安拉使她好字嗎
MayAllahKeepHimWell=願安拉使他好字嗎
MayAllahKeepThemFeminineWell=願安拉使他們女性好字嗎
MayAllahKeepThemMasculineWell=願安拉使他們男性好字嗎
MayAllahKeepYouCheerful=願安拉使你開朗字對字的嗎
MayAllahMaintainAllYourLifeFeminine=安拉可能保持所有你生活女性詞的詞嗎
MayAllahMaintainAllYourLifeMasculine=可能真主保持所有你生活男性詞對詞嗎
MayAllahMaintainAllYourLivesFeminine=安拉可能保持所有你生活女性詞的詞嗎
MayAllahMaintainAllYourLivesMasculine=可能真主保持所有你生活男性詞對詞嗎
MayAllahMaintainBothOfYourLives=安拉可能維持你們倆的生活字對字的嗎
MayAllahMakeYourRewardGreat=可能真主使你的獎賞偉大字對字的嗎
MayAllahProtectBothOfThem=可能真主保護他們字對字的兩個嗎
MayAllahProtectHer=安拉可能保護她字對字的嗎
MayAllahProtectHim=可能真主保護他字對字的嗎
MayAllahProtectThemFeminine=真主護佑女性詞對詞嗎
MayAllahProtectThemMasculine=真主護佑陽性詞對詞嗎
MayAllahProtectYouAllFeminineWithGoodness=願真主保佑你以善字對字的所有女性
MayAllahProtectYouAllFeminine=安拉可能保護你所有女性字一個字嗎
MayAllahProtectYouAllMasculineWithGoodness=願真主保佑你所有男性以善字
MayAllahProtectYouAllMasculine=安拉可能保護您所有男性字一個字嗎
MayAllahProtectYouBothWithGoodness=可能真主保護你這兩個善良字對字的嗎
MayAllahProtectYouBoth=安拉可能保護你這兩個字一個字嗎
MayAllahProtectYouFeminineWithGoodness=可能真主保護你女性以善字對字的嗎
MayAllahProtectYouFeminine=安拉可能保護你女性詞對詞嗎
MayAllahProtectYouMasculineWithGoodness=安拉可能保護你陽剛善字對字的嗎
MayAllahProtectYouMasculine=安拉可以保護你們男性詞對詞嗎
MayAllahWillItSoOLordOfTheWorlds=安拉可能將它這麼 OLord 的字對字的世界嗎
MayEveryYearYouBeInGoodHealthAndBlessings=可能你會身體健康，祝福詞對詞每年
MayEveryYearYouHaveGoodness=可能你有善字每年
MayGloriousAllahBePleasedWithBothOfThem=願光榮安拉喜悅他們字對字的兩個嗎
MayGloriousAllahBePleasedWithHer=願光榮真主喜悅她字對字的嗎
MayGloriousAllahBePleasedWithHim=願光榮真主喜悅他字對字的嗎
MayGloriousAllahBePleasedWithThemFeminine=願光榮安拉喜悅他們女性詞的詞
MayGloriousAllahBePleasedWithThemMasculine=願光榮安拉喜悅他們男性詞對詞
MayHisGloryBeGlorified=可能他的榮耀得著榮耀字
MayHisGloryBeRaised=可能引發他的榮耀字
MaymunaBintAlHarith=Maymuna Bint Al 哈裡斯字
MeaningOfEmptyCentreHighStop=空中心高停止詞對詞的意義
MeaningOfEmptyCentreLowStop=空中心低停止詞對詞的意義
MeaningOfEndOfAyah=年底保姆字卡的事的意義
MeaningOfPlaceOfSajdah=地方 Sajdah 字對字的意義
MeaningOfRoundedHighStopWithFilledCentre=圓形高停止與填充中心詞對詞的意義
MeaningOfSmallHighJeem=小高 Jeem 詞對詞的意義
MeaningOfSmallHighLamAlef=小高林 Alef 詞對詞的意義
MeaningOfSmallHighLigatureQafWithLamWithAlefMaksura=小高結紮 Qaf 隨林與 Alef Maksura 詞對詞的意義
MeaningOfSmallHighLigatureSadWithLamWithAlefMaksura=小高位結紮悲傷與林與 Alef Maksura 詞對詞的意義
MeaningOfSmallHighMeemInitialForm=小高米姆初始形式詞對詞的意義
MeaningOfSmallHighMeemIsolatedForm=小高米姆意義分離形式字一個字
MeaningOfSmallHighNoon=小高中午詞對詞的意義
MeaningOfSmallHighRoundedZero=小高意義圓形零字
MeaningOfSmallHighSeen=小高看到詞對詞的意義
MeaningOfSmallHighThreeDots=小高的三個點詞對詞的意義
MeaningOfSmallLowSeen=小低見詞對詞的意義
MeaningOfSmallWaw=小 Waw 詞對詞的意義
MeaningOfSmallYeh=小 Yeh 詞對詞的意義
MeaningOfStartOfRubElHizb=開始擦 El Hizb 詞對詞的意義
Meaning=意字的詞
Melting=熔詞對詞
MessengerOfAllah=字對字的安拉的使者
MethodologyOfQuranicInterpretation=古蘭經 》 解釋字對字的方法
MidShaban=中期沙班字
MinorAssociation=未成年人協會字
MinorIncorrectPronunciation=輕微不正確的發音詞對詞
MiraculousAspectsOfTheQuran=神奇的字對字的古蘭經 》 的方面
ModerateBounce=溫和反彈字
Moderation=節制字
MondayAndThursday=週一和週四字
Month11=Month11 字
Month12=Month12 字
Month3=Month3 字
Month4=Month4 字
Month5=Month5 字
Month6=Month6 字
MonthOfRamadanWhichWasRevealedThereinTheQuranGuidanceToMankind=齋月是其中揭示人類字對字的古蘭經 》 指南
Month=月字
Morocco=摩洛哥字
MosqueOfTheProphet=字對字的先知清真寺
MountNour=裝載努爾字
MountUhud=山吳字
MuathBinJabal=Muath Bin 山詞的詞
Muawiyyah=Muawiyyah 字
MuhammadBinAbdullahBinAbduAlMuttalib=默罕默德 · 本 · 阿卜杜拉 · 本 · 阿卜杜 Al Muttalib 字
MuhammadBinAlHasan=默罕默德本 · 阿爾哈桑字對字的
MuhammadBinAli=穆罕默德 · 本 · 阿裡字
MusaBinJafar=穆薩 · 本 · 賈法爾字
MysticCommentary=神秘的評注字
NamesAndAttributes=名稱和屬性詞對詞
NamesOfCountries=國家字對字的名字
NarrationBasedExegesis=敘述基於訓詁詞對詞
Nasalization=鼻音化字
NasalizeCharacterDoubled=Nasalize 字元逐字翻了一番
NasalPassage=鼻道詞對詞
Near=附近的字
NegationParticle=否定粒子字
NegativeCommand=消極的命令字
NobleQuran=高貴的古蘭經 》 詞對詞
NominalSentence=名義上句詞對詞
NoonGhunna=中午 Ghunna 字
NumberPlurality=數位多字
OAllahSendPrayersUponMuhammadAndTheFamilyOfMuhammad=O 真主發送默罕默德和穆罕默德的家人禱告詞對詞
ObligationOfSufficiency=充分性詞對詞的義務
ObligationOfTheSelf=自我詞對詞的義務
ObviousAnalogy=一個顯而易見的類比詞對詞
OChiefs=O 酋長字
OddPrayerAndAfter1=奇怪的禱告和 After1 字
OfTheGuestForTheHost1=賓客為 Host1 詞對詞的
OfTheResidentForTheTraveler1=居民為 Traveler1 字
OfTheResidentForTheTraveler2=居民為 Traveler2 字
OfTheTravelerAsDawnApproaches1=作為黎明 Approaches1 字對字的旅行者
OfTheTravelerForTheResident1=為 Resident1 字對字的旅行者
OLordGiveMeKnowledge=O 主給我知識字
OMasterSendPrayersAndPeace=O 我的主人|送來你的問候|和祝福|永遠|永恆|後|你心愛的人|最好的|創造的|整體的
OnenessOfAllah=真主字對字的統一性
OnenessOfDivinityAndWorship=合一的神和崇拜字
OnenessOfDivinity=合一的神字
OnenessOfLordshipDominion=合一的貴族統治字
OnenessOfNamesAndAttributes=名稱和屬性字對字的統一性
OnenessOfWorship=合一的崇拜字
OnWithTheTruth=關於用字對字的真理
Opening=打開字
OpinionBasedExegesis=意見依據訓詁詞對詞
Opinion=詞對詞的意見
OProphet=O 先知字一個字
OriginalLengthening=原始的延長字
OrnateLeftParenthesis=華麗的左的括弧字
OrnateRightParenthesis=華麗的右括弧字
OutrightBlindFollowing=徹底盲從字
O=O 字
OYouMankind=O 你是人類字
OYouWhoBelieve=O 你相信字
Pakistan=巴基斯坦字
PartialAbrogation=部分廢除字
PartiallyFlexible=部分靈活用詞的詞
ParticleOfPlace=粒子的詞對詞的地方
ParticleOfTime=時間詞對詞的粒子
ParticlesForOaths=宣誓詞對詞的粒子
ParticlesOfCondition=粒子的狀態字
ParticlesOfEmphasis=重點詞對詞的粒子
ParticlesOfInterogation=粒子的刑訊字
ParticlesOfNegation=粒子的否定詞的詞
ParticlesOfPlace=粒子的詞對詞的地方
ParticlesOfTime=時間詞對詞的粒子
ParticlesWithoutDeclension=顆粒無字詞形變化
PassiveParticiplePassiveNoun=被動的分詞被動名詞字
PassivePastTense=被動的過去時態詞對詞
PassivePresentTense=被動現在時字
PassiveVerb=被動式動詞詞對詞
PeaceBeUponYouAndMercyOfAllahAndBlessings=願主賜予你和仁慈的真主和祝福詞對詞
PeaceBeUponYouAndMercyOfAllah=願主賜予你和仁慈的真主字對字的
PeaceBeUponYou=願主賜予你字
PeaceSecure=和平安全字一個字
PeopleOfHadith=聖訓學家詞對詞的人
PeopleOfRealities=詞對詞的現實的人
PeopleOfReasoningOpinion=人的推理認為詞的詞
PeopleOfTheBook=字對字的書的人
PeopleOfTrueReality=人的真正的現實字
Philippines=菲律賓字
Phonation=發聲詞對詞
PhraseForAllahIsGreatestOfCommenceningPrayer=短語的真主是偉大的 Commencening 禱告詞對詞
PhraseForAllahIsGreatestOfConsecratedState=短語的真主是偉大的神聖狀態字
PhraseForAllahIsGreatestOfTransition=短語的真主是過渡的偉大詞對詞
PlacingChildrenUnderAllahsProtection1=Allahs Protection1 字下放置兒童
PlacingTheDeceasedInTheGrave1=將死者放在 Grave1 字
PleasedWithDecree=高興與旨令字
PointingConstruction=指出建設字
PointingNouns=指向名詞字
PointingNoun=指向名詞字
PossessionConstructionLikeNounsForTimePlace=擁有像名詞施工時間地點字
PossessionConstruction=擁有建設字
PossessionParticles=藏有粒子字
PossessiveConstruction=佔有欲建設字
Practical=實用字
PracticesOfThePeopleOfMedina=人民的麥迪那詞對詞的做法
PrayerSaidDuringAWindStorm1=禱告時風吹 Storm1 字說
PrayerSaidDuringAWindStorm2=禱告時風吹 Storm2 字說
PrayersUponTheProphet=字對字的先知的禱告
PrayTime8=禱告詞對詞 Time8
PrayTime9=禱告詞對詞 Time9
PreciseMethodicalRecitation=精確有條不紊朗誦詞對詞
Predicate=謂詞字
PresentOrFutureTenseVerb=現在或將來緊張動詞詞對詞
PresentTensePossessionParticles=現在時態擁有粒子字
PreservedTablet=保存的片字
ProphetOfAllah=真主字對字的先知
ProphetsOfAllah=真主字對字的先知
ProstratingDueToQuranRecitation1=因為古蘭經 》 Recitation1 字對字的禮佛
ProstratingDueToQuranRecitation2=因為古蘭經 》 Recitation2 字對字的禮佛
ProstrationOfForgetfulness=厥脫的健忘字
PurificationFromPhysicalFilth=從物理污穢詞對詞的淨化
PurificationFromSpiritualFilth=從精神污穢詞對詞的淨化
PurificationOfTheSoul=O 真主|你給|我的靈魂|其虔誠|你淨化它|你 (單獨)|最佳|誰|淨化它|你 (單獨)|其監護人|和它的主人
Pus=膿液字
QaasimBinMuhammad=本 · 穆罕默德 · 伽字
Quarter=季度字
QuestionMark=問號字
QuotationMark=引號字
QuranicGrammar=古蘭經 》 語法詞的詞
QuranicMetaphor=古蘭經 》 隱喻詞對詞
QuranicSciences=古蘭經 》 科學字
QuranPreservedInUthmaniScript=古蘭經 》 在 Uthmani Script 中保留字
RaaHeaviness=Raa 沉重字
RaaLightness=Raa 輕盈字
RaisingHandsInPrayer=舉手禱告詞對詞
RamlahBintAbiSufyan=Ramlah · 賓特 · 阿比揚字
RapidRecitation=快速背誦字
RationalInsights=合理的見解字
RationalLogicalMetaphorMetonymy=理性的邏輯隱喻轉喻詞對詞
RayhanaBintZayd=Rayhana · 賓特 · 宰字
RealisticJurisprudence=現實主義法學字
ReasonsForRevelation=啟示錄字對字的原因
RelatedOpinionBasedExegesis=相關的意見依據訓詁詞對詞
RelativeAdjective=相對形容詞詞對詞
RelativePlaceNouns=相對的地方名詞字
RelativePronoun=關係代詞字
RelativeTimeNouns=相對時間名詞字
Remembrance1=Remembrance1 字
Remembrance2=Remembrance2 字
RemembranceAfterGivingPeaceOfPrayer1=後給 Prayer1 字對字的和平的紀念
RemembranceAfterGivingPeaceOfPrayer2=後給 Prayer2 字對字的和平的紀念
RemembranceAfterGivingPeaceOfPrayer3=後給 Prayer3 字對字的和平的紀念
RemembranceAfterGivingPeaceOfPrayer4=後給 Prayer4 字對字的和平的紀念
RemembranceAfterGivingPeaceOfPrayer7=後給 Prayer7 字對字的和平的紀念
RemembranceAfterGivingPeaceOfPrayer8=後給 Prayer8 字對字的和平的紀念
RemembranceAtSittingOrGathering1=在坐著或 Gathering1 字對字的紀念
RemembranceBeforeSleeping10=前 Sleeping10 字對字的紀念
RemembranceBeforeSleeping11=前 Sleeping11 字對字的紀念
RemembranceBeforeSleeping13=前 Sleeping13 字對字的紀念
RemembranceBeforeSleeping4=前 Sleeping4 字對字的紀念
RemembranceBeforeSleeping5=前 Sleeping5 字對字的紀念
RemembranceBeforeSleeping6=前 Sleeping6 字對字的紀念
RemembranceBeforeSleeping7=前 Sleeping7 字對字的紀念
RemembranceBeforeSleeping8=前 Sleeping8 字對字的紀念
RemembranceBeforeSleeping9=前 Sleeping9 字對字的紀念
RemembranceFifth=我已接納|真主|作為主，|伊斯蘭|作為一種生活方式|和穆罕默德 (願他平安)|作為一個先知|和 (安拉) 的使者。|(背誦在阿拉伯文三倍)。
RemembranceFirst=無|有權受崇拜|但|您|榮耀是你|真正|我一直|/|做錯事的人
RemembranceFourth=O 真主!|尊崇和憐憫|在||默罕默德 (和平和他的祝福)，|你的僕人，|你們的先知，|和你的使者，|先知|文盲|和後|他的家人|和同伴，|並授予他們和平。
RemembranceSecond=對我們來說足夠|真主|和他是最好的|處置者事務|優秀|贊助人|和什麼優秀|説明器
RemembranceSeventh=O 真主!||我們尋求避難|在你|從||關聯其他|和你一起|任何檔案|雖然我們都知道它，|我們尋求悔改|為將其他的東西與你相關聯|非|雖然我們都知道它。
RemembranceSixth=O 我的主!|給你|所有的讚美是到期|作為|適合|到你光榮|目前狀態|和你很棒|主權。
RemembranceThird=有沒有|強度|還有沒有|電源|除了|以物配主|高|最高人民法院
RepelTheirEvilByMeansOfWhatIsBest=用什麼是最好的字對字的排斥他們的邪惡
Repetition=重複字
RepresentativeStem=代表幹字
ResponseStatementAfterCondition=回應聲明後狀態字
Restraint=克制字
ResurrectionSending=復活發送字
ReturningAGreetingToADisbeliever1=同意約見回到 ADisbeliever1 字
ReturningASupplicationAfterHavingBestowedAGiftOrCharityUponSomeone1=領受禮物或慈善機構 Someone1 字的後返回 ASupplication
ReturningSupplicationForForgiveness1=返回為 Forgiveness1 祈求字
RiadAlJannah=裡亞德阿爾奎字
Ridaa=Ridaa 字
RightCurlyBracket=右花括弧字
RighteousDealings=公義字
RighteousDeeds=善事的字
RightOfAllah=真主字對字的權利
RightPointingDoubleAngleQuotationMark=指著雙角引號詞對詞的權利
RightSquareBracket=字的右方括弧
RuleInImpliedMeaningAgreesWithStatedMeaning=規則中隱含意義同意陳述意思字
RuleInImpliedMeaningIsContrapositiveToStatedMeaning=規則中隱含的意義是對陳述意思字對字的逆
RuqayyahBintiMuhammad=賓蒂默罕默德 Ruqayyah 字
SaadBinWaad=薩阿德 Bin Waad 字
SaalimMawlaaAbeeHuthayfah=Saalim Mawlaa 不亦樂乎 Huthayfah 字
SacredMosque=神聖清真寺字
SadBinAbiWaqqas=悲傷的 Bin Abi 沃字
SadBinMalik=傷心本 · 馬利克字
SaeedBinZaid=賽義德 · 本 · 紮伊德字對字的
SafeguardYourselfFromHeWhoYouHaveBeenGoodTo=保護自己免受他那些你一直對字一個字好
SafiyyaBintHuyayy=Safiyya Bint Huyayy 字
SahihAlBukhari=阿爾布哈裡聖訓字
SahihMuslim=聖訓穆斯林字
SaidToOneOfferingADrinkOrTheOneWhoIntendedToDoThat1=若要對一種可以提供小酌時或打算去做: (1) 詞對詞的人說:
SalawatSupplicationAfterTalbiah=O 真主|送來問候|後|母片|默罕默德|和後|家庭|母片|默罕默德|正如|你送來問候|後|亞伯拉罕 ·|和後|家庭|亞伯拉罕 ·|並送上祝福|後|母片|默罕默德|和的家人|母片|默罕默德|正如|你送祝福|後|亞伯拉罕 ·|和後|家庭|亞伯拉罕 ·|於|所有的世界|你真是|值得稱讚|強大
SalutationsUponYouOfAllah=在你身上的真主字對字的稱呼
SaudiArabia=沙烏地阿拉伯字
SawdaBintZama=黑膽質 · 賓特 · 紮字
SayCallUponAllahOrCallUponTheMostMercifulWhicheverNameYouCallToHimBelongTheBestNames=說真主呼籲或呼籲最仁慈的人無論你叫他的名字屬於最好的名字字
Scale=規模字
ScientificExegisis=科學 Exegisis 字
Scorching=灼熱的字
SecondCreed=孤獨|否|夥伴|有他|和我的見證|那|默罕默德|他的僕人|和信使
SecondParticlePossessionConstruction=第二個粒子擁有建設字
Second=第二字
SeekingForgivenessAndRepentance3=我尋求寬恕|真主|強大，|誰|沒有|值得一的崇拜|除了|他，|生活，|是永恆的|我後悔|給他。
SeekRefugeWithAllahFromSatanRejected=尋求庇護真主從撒旦拒絕字一個字
SeenNoted=看到著名字
SeenRequired=看到所需字
Semicolon=分號字
SendBlessingsFirst=O 真主|發送你的憐憫|在|默罕默德|和後|後人|他的|作為|你發送你的憐憫|在|亞伯拉罕 ·|和後|後人|他的|你真是|最受讚賞|最光榮|和傳遞你的祝福|在|默罕默德|和後|後人|他的|作為|你寄給你的祝福|在|亞伯拉罕 ·|和後|後人|他的|於|世界|你真是|最受讚賞|最光榮
SendBlessingsSecond=O 真主|發送你的憐憫|在|默罕默德|和後|後人|他的|作為|你發送你的憐憫|在|亞伯拉罕 ·|和後|後人|他的|你真是|最受讚賞|最光榮|O 真主|傳遞你的祝福|在|默罕默德|和後|後人|他的|作為|你寄給你的祝福|在|亞伯拉罕 ·|和後|後人|他的|你真是|最受讚賞|最光榮
Sense=字對字的意義
SeparatedLengtheningGreatConnection=分隔延長大連接詞對詞
SeparatedLengtheningSmallConnection=分隔延長小連接詞對詞
SettlingADebt1=解決 ADebt1 字
SettlingADebt2=解決 ADebt2 字
SettlingOfRightsBetweenBelievers=定居的權利之間信徒字
Simile=比喻詞的詞
SixthCreed=O 真主|當然|我尋求保護|和你一起|從|那|我將與你的伴侶相關聯|任何檔案|和我|知道|it|和我尋求寬恕你|為此|非|我知道|it|我後悔|從它|我讓自己自由|從|不敢相信|和多神教|與謬誤|和背咬|與創新|和告訴故事|和惡行|和責備|和不服從|所有這些|和我提交|和我說|有沒有|神|除了|真主|默罕默德|信使|真主
SmallBounce=小幅反彈字
SmokeOfHell=地獄詞對詞的煙
SoftLengthening=軟延長字
SoundFemininePlural=健全女性複數詞對詞
SoundMasculinePlural=健全的男性複數詞對詞
Space=空間字
SpeechOfAllah=真主字對字的講話
StablizationLengthening=穩定延長字
StatedSimile=表示比喻詞的詞
StateofMajorRitualImpurity=國家主要儀式雜質字
SteadyLengtheningStop=穩定延長停止詞對詞
StoppingOrLodgingSomewhere1=停止或倒伏 Somewhere1 字
Stories=詞對詞的故事
Strength=字對字的力量
StrongerReasonArgument=更強的 Reason 參數字
StudentsOfFollowers=學生的字對字的追隨者
StudyOfRhetoricEloquence=修辭口才詞對詞的研究
SubjectNominalSentence=主題名義句詞對詞
SublimeAndMighty=崇高和強大字
SubordinatorsBeginningConditionalClauses=開始條件狀語從句詞對詞的手下
SubstituteLengthening=替代延長字
SubstitutionOfAPartForAWhole=替代分開推進器字
SubstitutionOfPartForTheWhole=替代整個逐字逐句的一部分
Sudan=蘇丹字
SuhaylBinAmr=蘇海勒賓 Amr 字
SumayyaBintiKhayatt=Sumayya 賓 Khayatt 字
SummarizedBlindFollowing=總結了盲從字
SunanAbiDawood=聖訓字
SunanAlTirmidhi=蘇南 Al 替字
SunanIbnMaja=蘇南 · 伊本 · 瑪雅字
SuperscriptAlefDaggerAlif=上標 Alef 匕首曝氣字
SupplicationAfterSalawatSupplication=O 真主|事實上|我尋求你|你的祝福|和天堂|我尋求庇護與你同在|從|憤怒|與地獄。
SupplicationForArrivingAtMakkah=O 真主|真正|此|聖所是|你神聖的地方|和這個聖城是|你的城市|和平中順是|你平安|然後禁止我|從|地獄火|把我拯救|從|你的懲罰|日時|你願意提高|你的僕人
SupplicationOfOpening=開放詞對詞的懇求
Taaif=Taaif 字
TahdhibAlAhkam=Tahdhib 薩克字
Talbiah=我已經回應你|O 真主|我已經回應你|我已經回應你|有沒有|夥伴|給你的|我已經回應你|真正|所有的讚美|和所有賞金|給你的|與主權|有沒有|夥伴|給你的
TalhaBinObaidullah=本 · 奧貝杜拉 Talha 字
Tall=高字
TaughtMankindWhatNotHeKnew=他知道字什麼不教導人類
TestifyingCreedOfIslamFirstPart=作證的伊斯蘭教第一部分字對字的信條
TestifyingCreedOfIslamSecondPart=作證的伊斯蘭教第二部分字對字的信條
TestifyingCreedOfIslam=證明信仰伊斯蘭教字
ThanksAllPraiseAndThanksIsToAllah=謝謝所有的讚美和感謝是對阿拉字
TheAbaser=Abaser 字
TheAcknowledgingOne=承認一詞對詞
TheAllAuthoritativeOne=擁有權威一詞對詞
TheAllAwareOneTheAllSeeing=大家都知道一個字都看到一個字
TheAllAwareOne=大家都知道一個詞的詞
TheAllCompelling=所有令人信服的逐字逐句
TheAllEnumeratingOne=所有枚舉一個字
TheAllHearerTheAllKnowingOne=所有聽眾都知道一個字對字的
TheAllHearerTheAllSeeing=所有聽眾都看到逐字逐句
TheAllHearerTheClose=所有的聽話者密切逐字逐句
TheAllHearer=所有的聽話人字
TheAllKnowingOneTheAllAwareOne=所有知道人都知道一個詞的詞
TheAllKnowingOneTheClementOne=所有知道人克萊門特的一個字
TheAllKnowingOneTheOmnipotentOne=我知道一個萬能的人字對字的所有
TheAllKnowingOneTheWiseOne=我知道一個明智的人字對字的所有
TheAllKnowingOne=都知道一個詞的詞
TheAllNobleOne=所有貴族一詞對詞
TheAllObservingWitness=所有觀測的證人字
TheAllPervadingOneTheAllKnowingOne=彌漫一知道一詞對詞的所有這一切
TheAllPervadingOneTheWiseOne=所有彌漫一明智一詞對詞
TheAllPervadingOne=所有彌漫一詞對詞
TheAllPrevailingOne=所有流行一個詞對詞
TheAllSeeing=字都看見一個字
TheAssemblerOfScatteredCreations=此組合語言程式分散創作詞對詞
TheBeautiful=美麗一詞的詞
TheBeneficent=仁慈的逐字逐句
TheBenignOneTheMerciful=良性的一個仁慈逐字逐句
TheBenignOne=良性的一個字
TheBestowerOfBenefits=好處字對字的安放
TheBestowerOfSufficiency=充分性詞對詞的安放
TheBestower=字對字的授與者
TheBountifulOne=豐收一詞對詞
TheBrilliant=字對字的輝煌
TheClear=明確逐字逐句
TheClementOneTheMerciful=克萊門特的一個仁慈逐字逐句
TheClementOneThePardoner=克萊門特的一個熱播詞的詞
TheClementOne=克萊門特的一個字
TheClose=密切逐字逐句
TheContinuousCreator=連續的造物主字
TheCoverer=防塵罩字
TheCreatorTheAllKnowingOne=造物主全知一字
TheCreator=造物主字
TheDaybreak=黎明字
TheDayOfArafah1=Arafah1 字對字的一天
TheDayOfArafah=阿拉法特字對字的一天
TheDayOfAshura=阿舒拉節字對字的一天
TheDistressor=Distressor 字
TheDoerOfGood=好詞對詞的實幹家
TheDominantOne=占主導地位的一個字
TheElevatingOne=提升一詞對詞
TheEmbodimentOfJustice=字對字的正義的化身
TheEmbodimentOfPeace=和平詞對詞的化身
TheEmbodimentOfTruth=字對字的真理的化身
TheEternalInheritor=永恆的繼承人字
TheEternalLordTheAllAuthoritativeOne=永恆的主擁有權威一詞對詞
TheEternalLordTheEmbodimentOfTruth=永恆的主字對字的真理的化身
TheEternalLordTheMostSacred=永恆的主詞的最神聖的字眼
TheEternalLord=永恆主詞的詞
TheEternalPossessorOfSovereignty=永恆的主權字對字的私密金鑰的持有人
TheEtiquetteOfPraisingAFellowMuslim1=禮儀的讚美 AFellow Muslim1 字
TheEtiquetteOfPraisingAFellowMuslim2=禮儀的讚美 AFellow Muslim2 字
TheEverAcceptorOfRepentanceTheMerciful=曾經承兌人悔改仁慈的字
TheEverAcceptorOfRepentanceThePardoner=過的悔改熱播詞對詞的承兌人
TheEverAcceptorOfRepentanceTheWiseOne=曾經的悔改明智一詞對詞的承兌人
TheEverAcceptorOfRepentance=曾經的懺悔詞對詞的承兌人
TheEverLivingTheBountifulOne=曾經的生活豐富一詞對詞
TheEverLivingTheCoverer=過生活防塵罩字
TheEverLivingTheSelfSubsistingOne=過生活自我生存一詞對詞
TheEverLiving=過生活字一個字
TheEverSurvivingOne=曾經尚存一詞對詞
TheEvilEye=邪惡之眼的字
TheEvolver=字對字的進化
TheExpeditingOne=加快一詞對詞
TheExtender=擴展程式字
TheExtensivelyEnduringOne=廣泛持久的一個字
TheExtremelyExaltedOne=極其崇高的一詞的詞
TheEyeOfSatan=撒旦詞對詞的眼睛
TheFirmOne=企業一詞對詞
TheFlawlessShaper=完美的牛頭刨床字
TheFountainHeadOfTruthTheMerciful=噴水頭的真相仁慈字
TheFountainHeadOfTruth=噴水頭的字對字的真相
TheGathererOfMankind=人類詞對詞的收集器
TheGentle=字對字的溫柔
TheGiver=字對字的記憶傳承者
TheGloriousOne=光榮的一個字
TheGood=好字
TheGreatForgiver=偉大的寬恕字
TheGreatOne=偉大一詞對詞
TheGuardingOne=守衛一詞對詞
TheGuideToPathOfRectitude=指南 》 清廉詞對詞的路徑
TheHelper=字對字的幫手
TheHolderOfSupremeAuthority=最高當局字對字的持有人
TheHonorerBestower=Honorer 安放字
TheImpartialJudge=字位公正的法官
TheImperceptible=不知不覺逐字逐句
TheInfiniteLastOne=無限的最後一個字
TheInflictorOfDeath=Inflictor 的死亡字
TheInfuserOfFaith=信念字對字的輸液器
TheInfuserOfNewLife=新生命詞對詞的輸液器
TheIrresistable=無法抗拒逐字逐句
TheJustOne=只是一個字
TheKnowerOfSubtletiesTheAllAwareOne=個人的微妙之處都知道一個字對字的知
TheKnowerOfSubtleties=個人的詞對詞的微妙之處知
TheLord=主詞的詞
TheLovingOne=有愛心的人字
TheMagnificentOneTheClementOne=華麗的一個的克萊門特的一個詞的詞
TheMagnificentOne=壯觀的一個字
TheMaintainerOfLife=維護者生活字
TheMajesticOne=雄偉壯觀的一個字
TheMasterLord=主耶和華字
TheMaster=主詞的詞
TheMatterHasBeenDecreed=這件事已經被欽點字
TheMercifulTheLovingOne=仁慈的愛一個詞的詞
TheMercifulThePardoner=憐恤熱播詞的詞
TheMercifulTheSupremePardoner=仁慈的人最高的熱播詞的詞
TheMerciful=仁慈的逐字逐句
TheMightyOneTheAllAuthoritativeOne=大能者的擁有權威的一個詞的詞
TheMightyOneTheAllKnowingOne=強大的人都知道一個詞的詞
TheMightyOneTheMerciful=大能者仁慈逐字逐句
TheMightyOneThePardoner=威勢熱播詞的詞
TheMightyOneTheSoleLaudableOne=強大的一個唯一值得稱讚的一詞的詞
TheMightyOneTheSupremeBestower=強大的一個最高安放詞的詞
TheMightyOneTheWiseOne=強大的一個智者一詞的詞
TheMightyOne=強大的一個字
TheMostGenerous=最慷慨逐字逐句
TheMostHigh=最高逐字逐句
TheMostHolyFromAllWeakness=最神聖的所有弱點字對字的
TheMostSacred=通過 Word 最神聖的字眼
TheNamesOfAllahAreBestFixedInTheBookAndTradition=真主的名字最好被固定的在書和傳統詞對詞
TheNamesOfAllahAreBest=真主的名字是最佳字
ThenHeHasDisbelieved=然後，他已不相信字一個字
TheNobleQuran=高貴的古蘭經 》 詞對詞
ThenTrulyThePartyOfAllahAreTheTriumphant=然後真正的真主党是勝利逐字逐句
TheOdd=奇數詞對詞
TheologyOfThePeopleOfTraditionAndTheGroup=在傳統的組字對字的人們的神學
Theology=神學字
TheOmnipotentKing=全能王字
TheOmnipotentOne=萬能的一個字
TheOneGod=一個神字
TheOneWhoCures=一個人治癒字
TheOneWhoRecompenses=那個報償字一個字的人
TheOnlyOneTheAllPrevailingOne=唯一的所有流行一個詞的詞
TheOnlyOne=只有一個字
TheOriginator=字對字的原始寄件者
TheOwner=字對字的擁有者
ThePardonerTheAcknowledgingOne=承認一字對字的熱播
ThePardonerTheClementOne=克萊門特一字對字的熱播
ThePardonerTheLovingOne=有愛心的人字對字的熱播
ThePardonerTheMerciful=仁慈的逐字逐句熱播
ThePardoner=字對字的熱播
ThePeopleOfTraditionAndTheGroup=在傳統的組字對字的人們
ThePerceptible=字可感知一個字
ThePointingOne=指向一個字
ThePossessorOfMajestyAndHonor=陛下和榮譽字對字的私密金鑰的持有人
ThePossessorOfTwoHorns=兩個喇叭字對字的私密金鑰的持有人
ThePowerful=強大的逐字逐句
ThePrayersOfAllahUponHimAndPeace=真主在他身上和和平詞對詞的祈禱
ThePrayersOfAllahUponHimHisFamilyAndPeace=真主對他他的家人和和平詞對詞的祈禱
ThePreserverOfSafety=保護者的安全詞對詞
ThePreventer=字對字的防噴器
ThePrimeLight=主要光字一個字
TheProcrastinator=拖延者字
TheProstratingOne=伏一詞對詞
TheProtectingAssociate=保護關聯詞的詞
TheProviderOfGuidance=字對字的指導供應商
TheProvider=供應商字
TheReckoningOne=推算一個字一個字
TheRecognizerTheAllKnowingOne=全知一字對字的識別
TheRecognizerTheClementOne=克萊門特一字對字的識別
TheRecognizer=識別器字
TheReducer=減速機字
ThereIsNoPowerAndNoMightExceptWithAllahMostHighMostMagnificent=有沒有權力和沒有可能除了與真主最高最宏偉字一個字
ThereIsNoPowerAndNoMightExceptWithAllah=有沒有權力和沒有可能除了與真主字
TheRespondingOne=回應一詞對詞
TheRestorer=恢復係詞對詞
TheRestrictingOne=限制一個字
TheRetaliator=Retaliator 字
TheRighteous=義人字
TheSelfSubsistingOne=自我的生存一詞對詞
TheSelfSufficientOneTheBountifulOne=自我的足夠一個豐富一詞的詞
TheSelfSufficientOneTheClementOne=自我的足夠一的克萊門特的一個詞的詞
TheSelfSufficientOneTheSoleLaudableOne=自我的足夠一個唯一值得稱讚的一詞的詞
TheSelfSufficientOne=自我足夠一詞對詞
TheShy=字對字的害羞
TheSickWhoHaveRenouncedAllHopeOfLife1=病人已放棄所有希望的 Life1 字
TheSickWhoHaveRenouncedAllHopeOfLife2=病人已放棄所有希望的 Life2 字
TheSickWhoHaveRenouncedAllHopeOfLife3=病人已放棄所有希望的 Life3 字
TheSoleLaudableOneTheGloriousOne=唯一值得稱讚的光榮的一個詞的詞
TheSoleLaudableOne=唯一值得稱讚一詞對詞
TheSoleOne=唯一的一個字
TheStrongOneTheMightyOne=堅強的人的強大的一個詞的詞
TheStrongOne=堅強的人字
TheSublimeOneTheAllAwareOne=崇高的人的都知道一個詞的詞
TheSublimeOneTheGreatOne=崇高的一個偉大一詞的詞
TheSublimeOneTheMagnificentOne=崇高的一個壯觀一個詞的詞
TheSublimeOneTheWiseOne=那個崇高的智者一詞的詞
TheSublimeOne=崇高的一個字
TheSupremeBestower=最高安放字
TheSupremeInHonor=在詞對詞的榮譽最高
TheSupremeOwnerOfSovereigntyAndGreatestThingsAndSupremeGlory=主權和最棒的事情和最高榮耀詞對詞的最高擁有者
TheSupremePardonerTheOmnipotentOne=最高的熱播萬能一詞對詞
TheSupremePardonerThePardoner=最高的熱播熱播字
TheSupremePardoner=最高的熱播字
TheSupremeProvider=最高供應商字
TheSupremeSolverTheAllKnowingOne=最高的規劃求解全知一字
TheSupremeSolver=最高的規劃求解字
TheSustainer=字對字的維繫者
TheSustainingOne=維持一個字
TheTaaOfFemininity=女性詞對詞的大亞
TheTaker=刺字
TheTalbiyah1=Talbiyah1 字
TheTotalProvider=共商字
TheTruthfulOne=真實的一個字
TheUniqueOneOfTheHeavensAndEarth=一個獨特的天地字一
TheUniqueOne=獨特的一個字
TheUniversalTrustee=普遍的受託人字
TheVeryFirst=第一個字一個字
TheWatchfulOne=警惕一詞對詞
TheWhiteMoonEighth=歡迎使用|一種好方式|你自己打給我們
TheWhiteMoonFifth=哦|我們的信使|在我們中間
TheWhiteMoonFirst=哦，上升|潔白的月亮|在我們
TheWhiteMoonFourth=對他來說|世衛組織邀請我們|向安拉|方式
TheWhiteMoonSecond=來自|山谷|所謂的"再見"
TheWhiteMoonSeventh=你帶來了|貴族|對這座城市
TheWhiteMoonSixth=誰來|與誡 》|必須服從
TheWhiteMoonThird=它是現任|要顯示的態度|在我們身上
TheWiseOneTheAllAwareOne=聰明的人都知道一個詞的詞
TheWiseOneTheAllKnowingOne=聰明的人都知道一個詞的詞
TheWiseOneTheSoleLaudableOne=聰明的人的唯一值得稱讚一個詞的詞
TheWiseOne=聰明的人字
ThirdCreed=榮耀|向安拉|和好評|向安拉|還有沒有|神|除了|真主|和阿拉|最大|和沒有|可能|和沒有|電源|除了|以物配主|最高|大多數的壯麗
ThreeLetterRootVerb=三信根動詞詞對詞
Throat=詞對詞的喉嚨
Time=時間詞的詞
ToADisbelieverWhenSneezes1=到 ADisbeliever 時 Sneezes1 詞的詞
Today=今天字
Tongue=舌字
ToOneWhoDoesYouAFavor1=到一個誰做你 AFavor1 字對字的
ToOneWhoHasOfferedYouSomeOfHisWealth1=一個人什麼也提供了一些他的 Wealth1 字
ToOneWhoPronouncesLoveForYouForAllahsSake1=向一位字對字的發音為 Allahs Sake1 對你的愛
ToTheDebtorWhenHisDebtIsSettled1=向債務人時他的債務是 Settled1 字
ToTheNewlyWed1=向新 Wed1 字
ToWardOffTheDeceptionOfTheObstinateDevils1=抵禦的頑固性 Devils1 字對字的欺騙
TraditionObligatory=傳統強制字一個字
TraditionVoluntary=傳統自願字
Transcendence=超越字
TransitiveVerb=及物動詞詞對詞
TrulyAllahIsWithThePatient=真正真主是字對字的患者
TrulyAllahLovesWhenOneWhoWorksDoesTheWorkWell=阿拉真正愛當一個人工作不工作好字
TrulyFromAllahWeComeAndToHimWillReturn=真正從真主我們過來給他將返回字
TrulyWithHardshipIsEase=真正的困難是易用性字
TrulyYouAreOnAnExaltedStandardOfCharacter=你真是對字元字對字的崇高標準
TwoLips=兩片嘴唇字
TypesOfSentences=類型的詞對詞的句子
UbayyBinKab=伍柏耶賓甲字
UmarBinAlKhattab=歐麥爾濱基地哈塔卜字
Umayyad=倭馬亞字
UmmKulthumBintiMuhammad=烏庫勒蘇姆賓默罕默德詞的詞
UnityOfAllah=真主字對字的統一
UniversalPrescription=通用的處方字
UnusualQuranicTerms=不尋常的古蘭經 》 條款字
UponBothOfThemBePeace=在他們兩個字對字的和平
UponBreakingFast1=于打破 Fast1 字
UponBreakingFast2=于打破 Fast2 字
UponCompletingAblution1=我可以作證|那|none|有權受崇拜|但|真主|孤獨|否|夥伴|有他|和我的見證|那|默罕默德|是他的奴隸|和他的使者
UponCompletingAblution2=O 真主|讓我|其中|那些人轉向你悔改|讓我|其中|那些人都的純化
UponCompletingTheMeal1=在完成 Meal1 字
UponCompletingTheMeal2=在完成 Meal2 字
UponEncounteringAnEnemyOrThoseOfAuthority1=當遇到敵人或那些 Authority1 字
UponEncounteringAnEnemyOrThoseOfAuthority2=當遇到敵人或那些 Authority2 字
UponEnteringATownOrVillage1=進入 ATown 或 Village1 字
UponEnteringTheHome1=量的名稱|真主|我們輸入|量的名稱|真主|我們離開|和後|我們的主安拉|我們依賴于
UponEnteringTheMosque1=我尋求庇護|在安拉|萬軍之耶和華，|由他的臉|高尚，|通過他的力量|原始，|從|撒旦|棄兒。|(在名稱中|真主，|和祝福)。|(與和平|安寧|信使|真主)。|O 真主|開啟|在我面前|門|你的仁慈。
UponExperiencingFearUnrestApprehensivenessDuringSleep1=一旦經受恐懼不安恐懼期間 Sleep1 字
UponHearingThunder1=在聆訊 Thunder1 字
UponHerBePeace=在她身上有和平字
UponHimBePeace=在他身上是和平字
UponHimHisFamilyPrayersAndPeace=他他家庭的禱告和和平字
UponHimOneThousandPrayersAndPeace=他一千祈禱和和平字
UponHimPrayersAndPeace=他的祈禱和和平字
UponLeavingTheMosque1=在名稱中|真主，|和祝福|與和平|安寧|信使|真主。|O 真主，|真正|我問|持續|您的青睞，|O 真主，|保護我|從|撒旦|棄兒。
UponReceivingPleasingOrDispleasingNews1=在收到討人喜歡或得罪新聞動態 1 字
UponRisingFromBowing1=後從 Bowing1 字對字的上升
UponRisingFromBowing2=後從 Bowing2 字對字的上升
UponRisingFromBowing3=後從 Bowing3 字對字的上升
UponSeeingEarlyOrPrematureFruit1=見狀早期或過早 Fruit1 字
UponSeeingSomeoneInTrialOrTribulation1=看到有人在審判或 Tribulation1 字
UponSightingTheCrescentMoon1=在瞄準新月 Moon1 字
UponSneezing1=在 Sneezing1 字
UponThemBePeaceFeminine=在他們身上是和平女性詞的詞
UponThemBePeaceMasculine=在他們身上是和平男性詞對詞
UthmanBinAffan=奧斯曼 · 本 · 阿凡字
UthmanicScript=Uthmanic 腳本字
VarianceDifferences=方差差異字
VerbalSentence=動詞句詞對詞
VerbInThePastTense=動詞過去時態詞對詞
VerilyAndItsSisters=實在和它的姐妹字
VerseOfTheSword=劍字對字的詩
VerseOfTheThrone=字對字的寶座的詩句
VersesOfRefuge=避難所字對字的詩句
Vibration=振動字
VisitingTheGraves1=前往 Graves1 字
VowellessMeemAssimilatingSmallIdentical=于米姆同化小相同字一個字
VowellessMeemClearGreater=于米姆清除更多字
VowellessMeemClear=于米姆清楚字
VowellessMeemHide=于米姆隱藏字
VowellessNoonAssimilatingNasalization=于中午同化鼻音化字
VowellessNoonAssimilating=于中午同化詞對詞
VowellessNoonClear=于中午清晰字
VowellessNoonCovered=于中午覆蓋字
VowellessNoonHideHeaviness=于中午隱藏沉重字
VowellessNoonHideLightness=于中午隱藏輕盈字
VowelLetter=母音字母詞的詞
WaraqahBinNawfal=沃拉格賓諾字
WawWithHamzaAbove=帶上喉塞音符逐字逐句 waw
Weakness=詞對詞的弱點
Week=周字
WeHavePutTrustInAllah=我們倚靠在安拉字
WeightedCompulsoryLengtheningLetters=加權義務教育延長字母詞的詞
WeightedCompulsoryLengtheningWords=加權義務教育延長詞字
WeSeekRefugeWithAllah=我們尋求避難以物配主詞的詞
WhenAtMountSafaAndMountMarwah1=當在裝載 Safa 和裝載 Marwah1 字對字的
WhenBreakingFastInSomeonesHome1=當快速磨合某人 Home1 字
WhenClosingTheEyesOfTheDeceased1=關閉 Deceased1 詞對詞的眼睛時
WhenEnteringTheMarket1=當進入 Market1 詞的詞
WhenFeelingSomePainInTheBody1=當感覺有些疼痛在 Body1 字對字的嗎
WhenGoingToTheMosque1=O 真主|地方|於|我的心|光線|和上|我的舌頭|光線|中和|我的耳朵|光線|中和|我的視線|光線|RD|我上面|光線|RD|我下面|光線|及至|我的權利|光線|及至|我的左邊|光線|RD|在我面前|光線|RD|在我身後|光線|名次|於|我的靈魂|光線|放大|對我來說|光線|和放大|對我來說|光線|車廠|對我來說|光線|讓我|一盞燈|O 真主|賜予我|光線|和地方|於|我的神經|光線|中和|我的身體|光線|中和|我的血|光線|中和|我的頭髮|光線|中和|我的皮膚|光線|(O 真主|成為|對我來說|一盞燈|於|我的墳墓|和光|於|我的骨頭)|(增加我在|光線|增加我在|光線|增加我在|光)|(格蘭特|我|光線|後|光)
WhenInFearOfAfflictingSomethingOrSomeoneWithOnesEye1=在恐懼的困擾與那些 Eye1 字對字的某人或某物時
WhenInFearOfAPeople1=當在 APeople1 字對字的恐懼
WhenInsultedWhileFasting1=當同時 Fasting1 字對字的侮辱
WhenItRains1=當它 Rains1 字
WhenLeavingTheHome1=量的名稱|真主|我信任|於|真主|有沒有|可能|和沒有|電源|除了|由阿拉
WhenLeavingTheHome2=O 真主|I|尋求庇護|在你|以免|我誤導別人|或|我是被誤導了別人|以免|我讓別人犯錯|或|我被造成孰能無過|以免|我辱駡他人|或|被濫用|和萊斯特|我亂來|或|別人的愚蠢|會見
WhenMountingAnAnimalOrAnyMeansOfTransport1=當越來越多的動物或任何手段 Transport1 詞的詞
WhenPraised1=當 Praised1 詞的詞
WhenSlaughteringOrOfferingASacrifice1=當屠宰或提供 ASacrifice1 字
WhenSomeoneBlessesYou1=當有人祝福 You1 字
WhenSomeoneElseWearingANewGarment1=穿破了|然後它被取代|(通過)真主|最高
WhenSomeoneElseWearingANewGarment2=穿上衣服|新增|過一種生活|值得一贊|死了依然是|烈士
WhenSomethingIsDifficult=當一些東西是很難字
WhenStrickenWithAMishapOrOvertakenByAnAffair1=當患曾經或超越由 Affair1 字
WhenTurningOverInTheNight1=當在 Night1 翻字的詞
WhenVisitingTheSick1=當前往 Sick1 詞的詞
WhenVisitingTheSick2=當前往 Sick2 詞的詞
WhenWakingUp1=讚美是|向安拉|誰|給我們的生活|之後||他已經導致了我們去死|對他|是返回
WhenWakingUp2=沒有|值得一的崇拜|但|真主|孤獨|否|夥伴|對他來說|他|是統治|對他|屬於所有的稱讚|他是|後|全部|事情|功能強大|榮耀|是對阿拉|稱讚|是對阿拉|沒有|值得一的崇拜|但|真主|真主|是最大|有沒有|可能|和沒有|電源|除了|真主的許可|崇高|強大|我的主|原諒我
WhenWakingUp3=稱讚|(是) 對阿拉|誰|給了力量|到|我的身體|和返回|對我來說|我的靈魂|和允許|我|要記住他
WhenWearingAGarment1=稱讚|(是) 對阿拉|誰|已經給與我穿上|這 (服裝)|(3) x|為我提供|從|其他比|電源|(的) 我自己|不能
WhenWearingANewGarment1=O 真主|給你|(是) 好評|您|給我穿上|我問你|持續|其善|與善良|什麼|取得了|為它|我尋求保護|和你一起|從|它的邪惡|與惡|什麼|取得了|為它
WhileAscendingOrDescending1=同時提升或 Descending1 字
WhileBowingInPrayer1=榮耀|向我的主|崇高。
WhileBowingInPrayer2=榮耀是給你，|O 真主，|我們的主，|和是你的讚美。|O 真主，|原諒|我。
WhileBowingInPrayer3=(給你)，榮耀|最聖潔 (是你)，|耶和華|天使的|和精神。
WhileBowingInPrayer4=O 真主，|給你|我鞠躬 (祈禱)|和你|我相信|和你|我已提交。|謙卑|在你面前|我的聽力是，|正如我的視線，|我的心，|我的骨頭，|我的神經|和什麼|已安裝|後 (旅費)|我的腳。
WhileBowingInPrayer5=榮耀是給你，|母片|權力，|統治，|威嚴的|和偉大。
WhileProstrating3=雖然 Prostrating3 字
WhileProstrating4=雖然 Prostrating4 字
WhileProstrating5=雖然 Prostrating5 字
WhileProstrating6=雖然 Prostrating6 字
WhileProstrating7=雖然 Prostrating7 字
WhileReturningFromTravel1=同時從 Travel1 返回字
Whispers=字對字的低語
Whistling=吹口哨字
WhoeverMemorizesThemWillEnterParadise=誰能夠記住這些將會進入天堂字
WiseOne=智者一詞對詞
WithDivineSuccessInExam=在考試詞對詞的神聖成功
WithDivineSuccess=與神聖成功字
Word=詞字
WorshipOfMeditation=冥想詞對詞的崇拜
YaasirBinAmir=亞斌 Amir 字
YearlyPredestination=每年緣分字
YehBarreeWithHamzaAbove=帶上喉塞逐字逐句 Yeh Barree
YehBarree=Yeh Barree 字
YehWithHamzaAbove=字一個字喉塞 Yeh
ZaydBinThaabit=Zayd Bin Thaabit 字
ZaynabBintiMuhammad=賓蒂默罕默德贊詞對詞
ZaynabBintJahsh=贊 · 賓特 · 哈士字
ZaynabBintKhuzayma=贊 · 賓特 · Khuzayma 字
WhileProstrating1=雖然 Prostrating1 字
Sham=深水字
PausingHamza=暫停喉塞音符詞對詞
GeneralAndSpecific=一般和具體詞的詞
SourcesOfAwareness=認識字的來源
HypotheticalJurisprudence=假設性判例字
AbuAmrBinAlAlaa=Abu Amr Bin 阿爾阿拉字
IbnKatheer=伊本 · 凱西爾字
Naafi=Naafi 字
IbnAamir=伊本 · 阿米爾字
Aasim=綏字
Hamza=喉塞音符詞對詞
AlKisaaee=Al Kisaaee 字
AbuJafar=阿布 · 賈法爾字
Yaqoob=雅各字
Khalaf=卡拉夫字
Warsh=許字
Hafs=哈夫斯字
TheGreatQuran=偉大的古蘭經 》 詞對詞
TheWiseQuran=明智的古蘭經 》 詞對詞
TheGloriousQuran=尊貴的古蘭經字
TheQuranFullOfReminder=古蘭經 》 充滿了提醒字
AClearQuran=明確的古蘭經 》 詞對詞
ANobleQuran=高貴的古蘭經 》 詞對詞
AGloriousQuran=尊貴的古蘭經字
LordOfTheWorlds=世界詞對詞的主
LordOfEverything=一切字對字的主
LordOfMosesAndAaron=Moses 和亞倫字之主
LordOfAaronAndMoses=亞倫和 Moses 字之主
LordOfTheThrone=— 寶座詞對詞的主
LordOfTheNobleThrone=— 崇高的寶座詞對詞的主
LordOfTheGreatThrone=大寶座詞對詞的主
LordOfTheHeavensAndTheEarth=上帝的天堂和地球字
LordOfTheHeavensAndTheEarthAndWhatIsBetweenThem=上帝的天堂和地球和什麼是他們字之間
LordOfYourFirstForefathers=你的第一列祖詞對詞的主
LordOfTheEastAndTheWest=東部和西部詞對詞之主
LordOfAllRisingsAndSettings=所有村級和設置字之主
LordOfEachPointOfSunrise=每一個日出點字對字的上主
LordOfThisCity=這座城市詞對詞的主
LordOfHonor=榮譽詞對詞的主
LordOfTheHeavens=耶和華天上字
LordOfTheEarth=地球詞對詞的主
LordOfSirius=天狼星詞對詞的主
LordOfTheTwoEasts=兩方字對字的上主
LordOfTheTwoWests=兩個西方詞對詞的主
LordOfThisHouse=這房子詞對詞的主人
LordOfDaybreak=黎明字對字的上主
LordOfMankind=人類詞對詞的主
LordOfTheSevenHeavens=耶和華七天上字
WorthyToBeFeared=值得讓人害怕字
WorthyToForgive=值得原諒字
PeopleOfTheHouse=字對字的房子的人
PeopleOfAHouse=人民的房子字
PeopleOfTheMessage=字對字的消息的人
PeopleOfTheGospel=人們的福音字
PeopleOfMadinah=人民的麥迪那字
PeopleOfATown=人民的 ATown 字
PeopleOfYathrib=人民的麥迪那字
PeopleOfMadyan=人民的 Madyan 字
PeopleOfTheCities=人民的字對字的城市
PeopleOfThisTown=這個鎮字對字的人
PeopleOfTheFire=人民的火字
CompanionsOfTheParadise=同伴們的字對字的天堂
CompanionsOfTheHappiness=同伴們的字對字的幸福
CompanionsOfTheRight=用詞恰當的字眼的同伴
CompanionsOfTheElevations=字對字的海拔的同伴
CompanionsOfTheCave=字對字的洞穴的同伴
CompanionsOfTheSoundPath=聲音路徑詞對詞的同伴
CompanionsOfTheShip=同伴們的字對字的船
CompanionsOfTheFire=字對字的火獄的居民
CompanionsOfTheHell=同伴們的字對字的地獄
CompanionsOfTheSabbath=安息日字的同伴
CompanionsOfThePessimist=悲觀主義者詞對詞的同伴
CompanionsOfTheLeft=字對字的左邊的同伴
CompanionsOfTheBlaze=字對字的大火的同伴
CompanionsOfThePit=字對字的坑的同伴
CompanionsOfTheElephant=字對字的大象的同伴
CompanionsOfMadyan=Madyan 詞對詞的同伴
CompanionsOfTheThicket=字對字的灌木叢的同伴
CompanionsOfTheRock=字對字的岩石的同伴
CompanionsOfTheWell=井字一個字的同伴
CompanionsOfTheCity=城市詞對詞的同伴
CompanionsOfTheGrave=字對字的墳墓的同伴
CompanionsOfMusa=穆薩詞對詞的同伴
WhispererWhoWithdraws=教唆者的毒害字
BlowerInKnots=鼓風機在結字
RelatedNarrationBasedExegesis=相關的敘述基於訓詁詞對詞
Remembrance3=Remembrance3 字
Remembrance4=Remembrance4 字
Remembrance5=Remembrance5 字
Thuwaybah=Thuwaybah 字
HalimahAlSadiyah=Halimah Al Sadiyah 字
ProperName=正確的名稱字
ImperativeVerbalNoun=命令式語言名詞字
RelativeDescriptivePronoun=相對描述性代詞字
PointingDemonstrativePronoun=指代詞字
ParticleOfPlaceAdverb=粒子的地方副詞字
ParticleOfTimeAdverb=時間副詞詞對詞的粒子
AccusativeParticle=賓格助詞字
PossessionParticlePreposition=藏有粒子介詞詞對詞
PossessionParticlesPrepositions=藏有粒子介詞詞對詞
NegativeParticle=負電粒子字
ConditionalParticle=有條件的粒子字
InterrogativeParticle=字對字的疑問語氣詞
AnswerParticle=答案粒子字
CoordinatingConjunction=並列連詞字
SubordinatingConjunction=從屬連詞字
AmendmentParticle=修訂粒子字
AversionParticle=厭惡粒子字
ParticleOfCause=粒子的字對字的原因
CertaintyParticle=確定性粒子字
CircumstantialParticle=旁證顆粒字
ComitativeParticle=Comitative 粒子字
EqualizationParticle=均等化粒子字
ExhortationParticle=勸勉粒子字
ExplanationParticle=解釋粒子字
ExceptiveParticle=例外粒子字
FutureParticle=未來粒子字
InceptiveParticle=初婚粒子字
ParticleOfInterpretation=粒子的字對字的解釋
PreventiveParticle=預防性粒子字
ProhibitionParticle=禁止粒子字
ResumptionParticle=恢復粒子字
RestrictionParticle=限制粒子字
RetractionParticle=回縮粒子字
ResultParticle=結果粒子字
SupplementalParticle=補充顆粒字
SurpriseParticle=驚喜粒子字
VocativeParticle=呼格粒子字
RelativeTimeNounsAccusativeNounIndicatingTimeWhenActionOccurs=行動發生時詞對詞的相對時間名詞賓格的名詞表示時間
RelativePlaceNounsAccusativeNounIndicatingPlaceWhereActionOccurs=行動發生詞對詞的相對的地方名詞賓格的名詞指示地方
ThirdPersonMasculine=第三人稱陽性詞對詞
ThirdPersonFeminine=第三人稱女性詞的詞
SecondPersonMasculine=第二人稱男性詞對詞
SecondPersonFeminine=第二人稱女性詞的詞
FirstPerson=第一個人字
ImperativeLaamPrefixNegativeCommand=必須 Laam 首碼負命令字
LaamOfEmphasisEmphaticLaamPrefix=Laam 重點強調 Laam 首碼詞對詞
ImperativeLaamPrefix=必須 Laam 首碼詞對詞
PurposeLaamPrefix=目的 Laam 首碼詞對詞
AlOfDefinitenessDeterminerPrefix=Al 的確定性限定詞首碼詞對詞
BouncingMechanism=彈跳機理字
VowellessLaam=于 Laam 字
LengtheningDueToHamza=由於哈姆紮字對字的延長
LengtheningDueToSukun=由於蘇坤逐字逐句延長
ConnectingSoftLengthening=連接軟延長字
SecondarySoftLengthening=二次軟延長字
LengtheningWithTwoCauses=有兩個原因字對字的延長
PronounHeh=代詞 Heh 詞對詞
TheRoundZero=圓形零字
TheStandingOblongZero=常設長圓形零字一個字
RelationshipInLikeness=相似詞對詞的關係
RelationshipInCloseness=在詞對詞的親密關係
RelationshipInSameTypes=在同一類型字對字的關係
RelationshipInDifferentTypes=在不同類型字對字的關係
RulesForEmptyHamza=空喉塞音符詞對詞的規則
TheStopOnEndsOfWords=詞字對字的兩端站
TheWritingOfTheFemaleHa=女性寫作詞的詞
WordsSpecificallyForTheHafsRecitation=專門為哈夫斯朗誦詞對詞的的詞
FormationsOfDifferentlyVoweledLetters=不同路警字母詞對詞的形成
LetterCharacteristics=信特徵詞的詞
ProstrationsOfReading=讀字 prostrations
DeepestPartOfTongue=最深的舌字對字的部分
MiddleOfTongue=中間的字對字的舌頭
EdgeOfTongue=邊緣的舌字
TipOfTongue=詞對詞的舌尖
DeepestPartOfThroat=最深的喉嚨字對字的部分
MiddleOfThroat=中間的字對字的喉嚨
ClosestPartOfThroat=最近的喉嚨字對字的一部分
TheOneWhoseHelpIsSought=一個為説明尋求字一個字
ThingsWhichServeThePublicInterest=逐字逐句地合乎公眾利益的事情
BlockingOfTheMeans=阻塞的字對字的手段
TheMostBeneficentTheMostMerciful=最仁慈最仁慈逐字逐句
TheMostMercifulTheOneWhoseHelpIsSought=最仁慈的説明是尋求字一個字
TheMightyOneTheGreatForgiver=強大的一個偉大的寬恕詞的詞
TheMightyOneTheBountifulOne=大能者的豐富的一個詞的詞
TheMightyOneTheAllCompelling=強大的一個字都令人信服一個字
TheClementOneTheGuideToPathOfRectitude=克萊門特的一個背離正道指南詞的詞
TheEmbodimentOfTruthTheClear=明確逐字逐句真理的化身
TheMostSacredTheEmbodimentOfPeace=最神聖和平的化身詞的詞
TheMostSacredTheMightyOne=最神聖的強大的一個詞的詞
TheEmbodimentOfPeaceTheInfuserOfFaith=和平的信念字對字的輸液器的化身
TheInfuserOfFaithThePreserverOfSafety=信仰的保護者安全詞對詞的輸液器
ThePreserverOfSafetyTheMightyOne=保護者的安全強大一詞對詞
TheAllCompellingTheDominantOne=所有令人信服的占主導地位的一個字
TheProtectingAssociateTheSoleLaudableOne=唯一值得稱讚一詞對詞保護副教授
TheGreatOneTheExtremelyExaltedOne=大一的極其崇高的一個詞的詞
TheCreatorTheEvolver=造物主字對字的進化
TheEvolverTheFlawlessShaper=完美的牛頭刨床字對字的進化
AndToYouAllMasculine=你所有男性詞對詞
AndToYouAllFeminine=你所有女性詞的詞
AndToYouBoth=給你兩個字的詞
AndToYouMasculine=男性詞對詞
AndToYouFeminine=女性詞的詞
TheNobleThrone=高貴的寶座字
TheGreatThrone=大寶座字
DisjointedLettersQuranicInitials=古蘭經 》 首字母縮寫脫節的字母詞對詞
SaleWithBuyBackContract=銷售與回購契約字
TradingOfDebt=交易的債務字
ExchangeContracts=交換合同字
InterestInExchangeContracts=利息交換合同字
InterestInLoanContracts=貸款合同字對字的興趣
ExcessiveMajorUncertainty=過大的不確定性字
MinorTolerableTrivialUncertainty=未成年人可以忍受瑣碎不確定性字
AlefSakinaWithFathaBeforeIt=Alef Sakina 與罰前字的罵
WawSakinaWithDammaBeforeIt=Waw Sakina 與前字 Damma
YehSakinaWithKasraBeforeIt=葉薩金娜與前字 Kasra
WawWithoutLengthening=沒有延長字 waw
YehWithoutLengthening=葉沒有延長字
TwoLipsFromInside=從內部字一個字的兩片嘴唇
UnderTheDeepestPartOfTongue=根據舌字對字的最深的部分
EdgeOfTongueLowestPart=舌頭最低部分字對字的邊緣
UnderTipOfTongue=根據提示詞對詞的舌頭
CloseToUnderTipOfTongueWithTop=根據與頂部字對字的舌尖靠近
TipOfTongueLetters=尖端的舌頭字母詞的詞
GumLetters=口香糖字母詞的詞
ElevatedGumLetters=高架的膠字母詞的詞
TipLetters=提示詞對詞的字母
AajurroomiyyahChapter1=文本|Aajurroomeeyah|於|語法|說|作者|可能對他的憐憫|真主:|種類|演講|有用的聲音:|它是|運算式/話語|加上，|有意義|在其句法的序列。|它唯一的零件組成的|第三:|名詞，|動詞，|與顆粒|來|與意義/意義。|然後名詞|眾所周知，|由於代理 kasra 運算式|和 noonation，|和進入|阿勒夫|和醋|在其上，|和字母|由於代理 kasra 的表達|和他們是|從|而至，|和約，|及後，|和，|而以，|和 baa，|和 kaaf，|和醋，|和字母|誓言，|和他們是|waw，|和呸，|和 tah。
AajurroomiyyahChapter2=和動詞|據悉，|與肯定，|見過，|並將|及 taa|女性氣質|母音-少。|粒子|it|非|不接受|與它|適應證|名詞的|而不是|適應證|名詞。|門|拐點|拐點|它是:|它改變了|結局|詞的|由區別|是活動元素攝政王|進入|在上面|表觀|或|假設。|和它的零件|有四個:|主格，|和賓格|和所有格，|與命令/斜案例、|然後為名詞|從|那|主格，|和賓格|和所有格，|而不是|命令/斜案例|在它，|然後為動詞|從|那|主格，|和賓格|與命令/斜案例、|而不是|所有格|在它。
AajurroomiyyahChapter3=第章|第一個|標誌|拐點/案件的結局|為主格|於|四|體征:|damma，|和 waw|和阿勒夫|到中午。|然後為|damma|然後它是|標誌|為主格|於|四|職位:|名詞|單個表單，|和複數|壞了，|和複數|女性|聲音，|和動詞|存在|其中|什麼也沒有|附加與聯繫|與它的結局|所有的東西。|和|waw|然後是|標誌|為主格|於|兩種情況:|於|複數|男性|聲音，|中和|名詞|五、|和他們是:|你的父親，|和你的兄弟，|和你的公公，|和你的嘴，|和擁有化學武器的國家|財富。|和|阿勒夫|然後是|標誌|為主格|於|雙|名詞|特別。
AajurroomiyyahChapter4=和|中午|然後是|標誌|為主格|於|動詞|目前，|當|已連結|與它|代名詞|二元性|或|代名詞|所述多個，|或|代名詞|女性氣質|每秒處理的人。|賓格|五|標誌|罰的罵，|和阿勒夫|和 kasra，|和呀，|和刪除|中午。|然後為|罰的罵|然後是|標誌|為賓格|於|三|例:|於|名詞|奇異，|和複數|壞了，|和動詞|現在時態|當|輸入|到它|虛擬語氣的情況下，|並沒有|已連結|與它的結局|所有的東西。|和|阿勒夫|然後是|標誌|為賓格|於|名詞|五、|就像:|(我見過|你的父親|和你的兄弟)|和什麼|類似|那。
AajurroomiyyahChapter5=和|kasra|然後是|標誌|為賓格|於|複數|女性|聲音。|和|是啊|然後是|標誌|為賓格|於|雙|和複數形式。|和|刪除|中午的|然後是|標誌|為賓格|於|動詞|五|其中|它主格|與恒常性|中午。|所有格|三|體征:|kasra，|和呀，|和罰的罵。|然後為|kasra|然後是|標誌|為所有格|於|三|例:|於|名詞|單數|完全屈折，|和複數|已中斷|完全屈折，|中和|複數|女性氣質|聲音。|和|是啊|然後是|標誌|為所有格|於|三|例:|於|名詞|五、|中和|二元性|和複數形式。
AajurroomiyyahChapter6=和|罰的罵|然後是|標誌|為所有格|於|名詞|其中|非|完全屈折變化。|其命令的理由|兩個標誌:|蘇坤|和刪除。|然後為|蘇坤|然後它是|標誌|命令的理由|於|動詞|存在|聲音|結束。|和|刪除|它是|標誌|為命令|於|動詞|存在|弱|結局|中和|動詞|五|其中|它指示|切除|中午。|分區|屈折變化|屈折變化|分為兩個部分:|部分|屈折變化|與母音的跡象，|和部分|屈折變化|用字母。
AajurroomiyyahChapter7=然後，|屈折變化|與母音跡象|四|事情:|名詞|奇異，|和複數|破碎的|和複數|女性|聲音，|和動詞|現在時態|其中|非|連接的|與它的結局|所有的東西。|和他們每個人都|由主格|與 damma，|和做賓格|與罰的罵，|和做的所有格|與 kasra，|和作出的命令|與蘇坤，|和失散|從|那|三|事情:|複數形式|女性氣質|聲音|作賓格|與 kasra，|和名詞|其中|非|充分 inflectable|是由所有格|與罰的罵，|和動詞|存在|已連結|它的結局|命令|與刪除|它的結局。|而|反映|用字母|四|類型:|雙，|和複數|男子氣概|聲音，|和名詞|五、|和動詞|五、|和他們是:|他們兩個男性做，|和他們兩個女性你們兩個做|他們所有男性這樣做，|所有男性的你，|和女性的你。
AajurroomiyyahChapter8=然後為|二元性|然後你讓主格|alef|你讓賓格|和使所有格|與嚴。|和|複數|男子氣概|聲音|然後它使主格|帶有 waw|和使賓格|和使所有格|與嚴。|和|名詞|五|然後它使主格|帶有 waw，|和使賓格|alef，|和使所有格|與嚴。|和|動詞|五|然後它使陳述語氣|中午，與|和使虛擬語氣|和使命令心情|刪除它。|這一章|動詞的|動詞|有三個:|過去時態，|和現在時態|和命令緊張|就像:|他打了，|和他打嗎，|和命中。|過去時態:|與罰的罵|結局|總是，|和命令緊張|命令|始終。
AajurroomiyyahChapter9=和現在時態|什麼|是|於|它的第一|一|增加的內容|四|其中|當加入到它的時候|你可以說:|(tah、 中午、 閻喉塞音符)|它是|主格|總是，|直到|進入|在上面|虛擬語氣|或|命令。|然後 subjunctiveness|十年|和他們是:|到那，|和永遠不會 / 不會|和那時/因此，|並且，為了到所以，|和林|因此|和林|逃稅行為，|和直到/達，|和一個句子的回應，結論，扼要子句|與發|和 waw|和或。|和命令|八|十、|和他們是:|沒有，|並不是什麼，|也沒有，|和什麼不一樣，|和林|命令|和懇求，|RD|(不做)|於|禁止|和懇求，|和，如果，|和什麼，|和誰，|無論，|每當 / 如果|什麼，|而，|時候，|在哪裡|和下落，|和這樣，|何地，|然而，|和那時/因此|於|詩歌|具體。
AajurroomiyyahChapter10=第章|主格例的|名詞的|主格例|7、|和他們是:|活躍的元素，|和物件|其中|非|一直叫|它的主題，|問題，|和謂語，|和的名詞|(是) / 動詞是|和它的姐妹，|和的謂詞|(當然) / 賓格粒子|和它的姐妹，|和追隨者|主格的|它是|四|事情:|形容詞，|和一起，|並強調，|和替代。|這一章|活動元素的|活動元素|它是:|名詞，|主格，|一提|在它之前|其動詞。|它是|後|兩個部分:|很明顯，|和隱藏，|然後明顯|就像|你說:|站在|宰，|和站|宰，|和站在那裡|兩個 Zayds，|和站|兩個 Zayds，|和站在那裡|Zayds，|和站|Zayds，|和站在那裡|男人，|和站|男人，|和站在那裡
AajurroomiyyahChapter11=後腿，|和站|後腿，|和站在那裡|兩個海因茲，|和站|兩個海因茲，|和站在那裡|不要驚動，|和站|不要驚動，|和站在那裡|不要驚動，|和站|不要驚動，|和站在那裡|你的兄弟，|和站|你的兄弟，|和站在那裡|小男孩奴隸|和站|小男孩奴隸|和什麼|是類似于|那。|隱藏|是兩個|十、|就像|你說:|(我打，|和我們打，|和你陽剛打，|和你女性的命中，|和你兩個打，|和你所有男性打，|和你所有女性打，|和他打了，|和她打，|和他們兩個打，|和他們陽剛打，|和他們女性打)。|第章|外力|其中|沒有|通話|其積極的元素|和它是:|名詞，|主格，|其中|沒有|提及|與它|其積極的元素。|然後如果|是|動詞|過去時態|把 damma|第一; 首先|把 kasra|什麼|之前|其結局/倒數第二|如果|是|現在時態|把 damma|第一; 首先|把罰的罵|什麼|之前|其結局/倒數第二。
AajurroomiyyahChapter12=它是|後|兩個部門:|很明顯，|和隱藏;|然後明顯|就像|你說:|(被毆打/點擊|紮伊德)|RD|(是毆打/點擊|紮伊德)|RD|(榮獲|) Amr|RD|(是榮幸|Amr)。|隱藏|二|十、|就像|你說:|(我是毆打/命中，|和我們被毆打/命中，|和你男性被毆打/命中，|和你女性被毆打/命中，|你們倆毆打/命中，|和你所有男性被毆打/命中，|和你所有女性被毆打/命中，|和他被毆打/命中，|和她被毆打/命中，|兩人毆打/命中，|和他們男性被毆打/命中，|和他們女性被毆打/命中)。|(章|主題|和謂詞)|主題:|它是|名詞|主格|空閒|從|原因/因素/主動元素|口頭表達 /|和謂詞:|它是|名詞|主格|從屬參照|到它，|就像|你說:|(宰|是站)|RD|(兩個 Zayds|站)|RD|(Zayds|站)。
AajurroomiyyahChapter13=和主題|有兩個部分:|很明顯，|和隱藏;|然後明顯|什麼|來之前|其一提，|隱藏|二|十、|和他們是:|我，|我們，|你陽剛，|你女性，|你們兩個，|你所有男性，|你所有的女性，|他，|她，|他們兩個，|他們陽剛，|他們女性，|就像|你說:|(I|我站|和我們|站)|和什麼|是類似于|那。|和謂詞|有兩個部分:|單數;|和其他比|奇異，|然後是單數|就像:|(宰|是站)|和其他比|單數|四|事情:|介詞|和它支配這個詞在所有格形式，|和間接言語名詞，|和動詞|含有|其積極的元素，|和主題|含有|其謂語|就像|你說:|(宰|在其中|房子，|和 Zayd|就在附近/你，|和 Zayd|是站|他的父親，|和 Zayd|他女性的奴隸/阿比蓋爾|去)。
AajurroomiyyahChapter14=這一章|功能/元素/致使概念|進入|後|主題|和謂詞|和他們是|三|事情:|動詞是|和它的姐妹，|和賓格粒子當然可以|和它的姐妹，|我想|和它的姐妹。|然後為|be/(was) 對動詞|和它的姐妹，|然後當然它|使得主格|名詞，|和使賓格|謂詞，|和他們是:|動詞是，|和它在夜晚，成為了|和它變成 / 早晨，成為|和它在那天上午，成為了|和他保持的所成為的|和它在夜晚成為了/他花留夜/一夜之間，|它變成了，|而不是|還有 (繼續)|他是|並不是保持|他是停止某事，|和不/不斷|他是停止某事，|和仍然/繼續|他是|而且只要|他剩餘，|和什麼|推匯出|從他們|就像:|他是，|他是|和，|和他成為了/它成為了早晨，|和他成為/它變得早晨，|成為 (上午)|你說:|(是|宰|站，|並不是|Amr|凝視著/看了一眼眼中)|和什麼|是類似|到那。|和|當然賓/粒子|和它的姐妹|然後當然它|讓賓格|名詞|和使主格|謂詞，|和他們是:|當然/的確/實在，|而且，|但是，|好像，|希望 / 如果只，|也許，|你說:|實在|紮伊德|站，|我希望|Amr|被盯著看的所凝視的
AajurroomiyyahChapter15=和什麼|類似|到它，|和意義|肯定|和那|強調，|但|為校正/整改/對供應的是缺掉的|因為如果|相比之下，|和想要是|祝福，|也許|希望|和期望。|和|我思想雙賓動詞|和它的姐妹|然後當然它|讓賓格|主題|和謂詞|後|那兩個|採取行動|對他們來說，|和他們是:|我思想/相信/認為，|和我思想/相信/認為，|和我思想/相信/認為，|和我思想/相信/認為，|我知道，|我知道，|而我發現，|和我了，|和我做了，|並聽取了;|你說:|我以為|宰|站起來了，|我看見|Amr|凝視所看，|和什麼|是類似|到那。|(章|形容詞)|形容詞:|一個追隨者|被描述的詞|於|它主格|和其賓格|和它的所有格，|和確定性|和不確定性;|你說|站在|宰|智慧，|我看見|宰|智慧，|和我通過|由紮伊|智慧化。
AajurroomiyyahChapter16=確定性|五|事情:|名詞|隱含的代名詞形式|就像:|I|和你，|和名詞|正確|就像:|宰|和麥加，|和名詞|模糊/不清楚/示範|就像:|這個男性|和這個女性|而這些，|和名詞|其中|在它|阿利夫|和林|就像:|男子|和那個男孩，|和什麼|附加|到|一|從|這些|四。|和不確定:|每|名詞|一般/常用|於|其性別|非|指定|與它|一|沒有|其他，|和其密切的理解:|全部|那|使用|條目|alef 的|和林|在其上，|就像|男子|和那匹馬。|第章|結合|和顆粒|結合|十年|和他們是:|waw /，|和美國聯邦航空局/和/所以/那時，|和那時/下一步，|或，|或，|或者，|但是，|而不是，|但是，|直到|於|部分|地方。
AajurroomiyyahChapter17=然後如果|被連體|與它|後|主格案例/指示心情|這將是主格案例/指示心情，|或|後|賓格案件語氣|它將是賓格的案例/虛擬語氣，|或|後|所有格|這將是所有格，|或|後|命令的心情|它將命令的心情，|你說:|(站在|宰|和 Amr，|我看見|宰|和 Amr，|和我通過|由紮伊|和 Amr，|與紮伊|沒有|矮櫃|也沒有|坐)。|這一章|強化重點/同位語的|重點:|(一個追隨者|為強調明確的詞|於|它主格|和其賓格|和其所有格|和其確定性)。|和是|與運算式|特定，|和他們是:|自我，|和自我/相同，|和每個/一切，|和整個/整體/一切，|和追隨者|複數/整個/整體/一切，|和他們是:|所有/一共/整體/全緣，|和所有/一共/整體/全緣，|和所有/一共/整體/全緣，|你說:|站在|宰|自己，|我看見|人民|所有的人，|與我擦肩而過|人民|所有。
AajurroomiyyahChapter18=這一章|替代的|當|我替換|一個名詞|從|一個名詞|或|一個動詞|從|一個動詞|它遵循|於|全部|它的拐點。|它是|後|四|部件:|替代/更換|東西|從|東西，|和替代|某些部分|從|整體，|和替代|安全殼/包容性|和替代|不正確/錯誤，|就像|你說:|(站在|宰|你的兄弟，|我就吃了|一卷/條麵包|第三，|和給我帶來好處|紮伊德|他的知識，|我看見|紮伊德|馬)，|你想要|那|你說的|我看見|那匹馬|然後以犯錯誤以為|然後代|紮伊德|從它。|第章|接動名詞做賓語的|名詞的|接動名詞做賓語|五|十、|和他們是:|所作所為後|通過它，|和不定式|和副詞|時間，|和副詞|地方，|和條件，
AajurroomiyyahChapter19=和規格，|和除外/排除在外，|和名詞|不，|和呼格的名詞，|並採取行動 / 物件|持續|為了它，|並採取行動 / 物件|伴隨著它，|和謂詞|動詞，是的|和它的姐妹，|和名詞|當然賓/粒子的|和它的姐妹，|和追隨者|為賓格|和他們是|四|事情:|形容詞，|和一起，|並強調，|和替代。|第章|物件/行事|由它|和它是:|名詞，|賓格|其中|位於|在上面|動詞，|就像|我打節拍擊中|紮伊德，|我騎|那匹馬。|它是|兩個部分:|明顯的/名詞，|並暗示/代詞;|然後明顯|非|開始|它的提及，|和默示|兩個部分:|附加，|和失散，|金及附加|是兩個|十、|和他們是:|他命中/擊敗我，|和他命中/擊敗我們，|和他命中/擊敗你陽剛，|和他命中/擊敗你女性，|和他命中/擊敗你們兩個，|和他命中/擊敗你所有男性，
AajurroomiyyahChapter20=和他命中/擊敗你所有女性，|和他命中/擊敗他，|和他命中/擊敗她，|和他命中/擊敗他們兩個，|和他命中/擊敗他們陽剛，|和他命中/擊敗他們女性。|和失散|是兩個|十、|和他們是:|我，|而我們，|和你陽剛，|和你的女性，|還有你們兩個，|和你所有男性，|和你所有女性，|和他，|和她，|和他們兩個，|和他們的男子氣概，|和他們的女性。|第章|不定式的|動詞不定式|它是:|名詞，|賓格|其中|來自|第三個|於|共軛|動詞，|就像:|他打了，|他打了，|打。|它是|兩個部分:|發音/言語，|而語義/方面的意義，|然後如果|同意|它的發音|發音|其動詞的|然後它是|發音/言語，|就像:|殺了他|殺戮/致命，|如果|同意|意義|其動詞的|沒有|其送電|然後它是|語義/有關的意思，|就像:|我坐在|坐在上下，|和我站在|一個站/向上/高高的|和什麼|是類似于|那。
AajurroomiyyahChapter21=第章|對副詞|時間，|與副詞|地方|副詞|時間|它是:|一個名詞|時間|賓格|與暗示|(中)|就像|一天，|夜晚，|清晨，|清晨，|和前一天休息的時間|今明兩天，|深夜人的第一第三|到了中午，午夜|和晚上，|和永遠/總是/無止境的|和很長的時間，|和一些時間。|和什麼|是類似于|那。|與副詞|地方|它是:|一個名詞|地方|賓格|與暗示|(在)，|就像:|前面，|和隱藏，|和前面的|和隱藏，|及以上，|及以下，|與在/由/，|和對面/面對/臉去面對，|和對面/面對/臉去面對，|和前面的|和那裡/在那邊，|然後，|在這裡，|和什麼|是類似于|那。|(章|條件)|條件|is:|名詞，|賓格|解釋|為此，|是模糊/模糊/可疑|從|條件時|就像|你說:|(來了|宰|騎馬)|RD|(我騎
AajurroomiyyahChapter22=那匹馬|它勝過一切)|RD|(我見過|僕人|真主|騎馬)|和什麼|是類似于|那。|而不是|ㄧㄣ|條件|除了|無限期，|而不是|ㄧㄣ|除了|之後|完成|演講中，|而不是|ㄧㄣ|其助理/追隨者|除了|明確。|這一章|規範的|規格|它是:|名詞，|賓格的情況下，|解釋|為此，|不清楚|從|精華，|就像|你說:|(滴|紮伊德|汗水)|RD|(爆炸爆裂 /|巴克爾|在脂肪)|RD|(是好|默罕默德|人)|RD|(我買了|二十|書)|RD|(我擁有|九十歲|羊羊/女)|RD|(宰|是更光榮/高貴|比你|作為一位父親)|RD|(他是更美麗|比你|在面部外觀/外觀)。|而不是|ㄧㄣ|除了|無限期，|而不是|ㄧㄣ|除了|之後|完成|講話。
AajurroomiyyahChapter23=這一章|異常/驅逐的|和顆粒|異常的|八項，|和他們是:|除外，|和其他比，|除了 / 其他比/與不同的是，|除了 / 其他比/與不同的是，|以及是否，|除了分開從|除了分開從|除了分開從。|然後除外|通過除外|讓賓格|當|是|這次演講|完成|積極，|就像:|(以發言|人民|除了|紮伊德)|RD|(左|人民|除了|) Amr|如果|是|這次演講|負|完成|允許允許的話|在它|替代|賓格|後|例外，|就像:|(不|站在|人民|除了|紮伊德)|RD|(除外|紮伊德)|如果|是|這次演講|未完成|是|後|根據|功能/因素，|就像:|(不|站在|除了|紮伊德)|RD|(不|我擊中/擊/擊敗|除了|紮伊德)|RD|(不|我通過|除了|由紮伊德)。|和異常|與/除以外，與不同的是，|除了 / 其他比/與不同的是，|除了 / 其他比/與不同的是，|和其他比|所有格|非|其他。
AajurroomiyyahChapter24=和異常|與除分開從|除了分開從|除了分開從|它允許|其賓格|和它的所有格，|就像:|(站在|人民|除了|紮伊德，|與紮伊)|RD|(除外|Amr|和 Amr)，|RD|(除外|巴克爾|和巴克爾)。|第章|(沒有)|知道|那|(沒有)|讓賓格|無限期|與其他比|noonation|If|之間的自然數|無限期|也沒有|重複|(沒有)|就像|(沒有|人類|於|那所房子)。|然後如果|沒有|後立即來|需要|主格|和需要|重複|(沒有)|就像:|(不|於|這房子|一個男人|也不是|一個女人)|然後如果|被重複|(沒有)|它是允許有|它的功能|以及它的撤銷，|然後如果|你想要|你說:|(沒有|人類|於|這房子|也不是|女人)。
AajurroomiyyahChapter25=這一章|呼格的|呼格|五|類型:|單數|專有名詞，|與不確定性|已知或意欲，|與不確定性|其他比|已知或意欲，|和附加/擁有，|和類似|與附加/擁有。|然後為|單數|專有名詞，|與不確定性|目的|然後都是結構|後|damma|從|其他比|noonation，|就像|(O) Zaid|RD|(啊)|和三個|剩餘|賓格|否|其他。|第章|物件/行事|從|成因的緣故|和它是:|名詞，|賓格|其中|提及|解釋|原因|發生|行動，|就像|你說:|(站在|紮伊德|出於尊重|為 Amr)|RD|(我來找你|渴望|那對你有好處)。
AajurroomiyyahChapter26=第章|物件/行事|與它 / 伴奏|和它是:|名詞，|賓格的情況下，|其中|被提及|與指定|從|誰是做對|與它|行動，|就像|你說:|(來了|領袖|與軍隊)|RD|(成為水準|水|用木頭)。|和|謂詞的|(是) / 動詞是|和它的姐妹|和的名詞|(當然/的確) / 賓格粒子|和它的姐妹|然後當然|來之前|提到的兩個|於|nominatives，|和像那樣|追隨者;|當然|來之前|那裡。|這一章|屬格結構的|從|名詞|屬格結構|有三個|種類:|所有格|與粒子介詞|和所有格|與附件/藏建設，|和追隨者|所有格。|和|所有格|與介詞/顆粒|然後是:|什麼|是由所有格|通過從，|和到/對，|和從，|及後，|和，|和一些/許多/也許，|和呸，|和 kaf，
AajurroomiyyahChapter27=和林|和之前的粒子的介詞|誓詞 》:，|和他們是:|waw|和呸，|和 tah，|和以 waw|可能，|和與以來，|和自 / 前。|和|這其中|使得所有格|與附件/藏建設，|然後就像|你說:|(男孩和僕人|紮伊德) 的|它是|後|兩個部分:|這其中|被暗示|與林，|和什麼|被暗示|與從;|和那個的|被暗示|與林|就像|(男孩和僕人|紮伊德) 的|和那個的|被暗示|與從，|就像|(服裝|絲綢)|RD|(一扇門|鐵片)|RD|(環|鐵)。|已完成|與所有的讚美和感謝|向安拉。
GreatMasterpieceCover=傑作|太棒了。|與解釋|介紹|Aajurroomiyyah。
GreatMasterpieceIntro=在名稱中|真主|最仁慈|最仁慈。|所有的讚美|是對阿拉
GreatMasterpiece1=介紹:|定義|語法，|它是一門學科，|它的好處，|它有之前起源的關係|和一位作家，|裁決|伊斯蘭法|在它。|定義:|意義|(的語法)|參照到|於|語言|阿拉伯文的|在|多|含義:|從它|方向，|它說:|我去了|在的方向|任何人|即:|它的方向。|並從它|類似|和類似，|它說:|默罕默德|看起來像|阿裡，|即:|它是類似|和它是一樣。|是指|意義|語法|於|術語|科學家|在|(知道|規則 》|其中|讓人理解|與它|裁決|結尾的|字|阿拉伯文|於|案例|它是建設:|從|詞形變化，|和結構|和什麼|如下|那)。|主題:|主題|知識|語法:|字數|阿拉伯文|從|方向|搜索|持續|雕像|提到。|好處:|效益|研究|知識|語法:|保護|舌頭的|從|錯誤|於|這次演講|阿拉伯文|和理解|古蘭經 》|高尚|和傳輸|預言|和理解|真實，|這兩個，|現在|基礎|法律|伊斯蘭|在這兩個|他們的中心。|創始人:|它是|從|規則 》|阿拉伯文。|第一作者:|和眾所周知|那|第一; 首先|要把|知識|語法|他是|父親|黑色的|Du'alee，|由命令|指揮官的|忠實的|阿裡|兒子|父親|布|很高興|可以阿拉|與他。|這項裁決|伊斯蘭法|在它|和學習它|是一項義務|從|義務|集體、|也許|指定|要瞭解|後|一個人|它變得|義務|個人的|身上。
GreatMasterpiece2=量的名稱|真主|最仁慈|最仁慈。|說|活頁簿:|他是|父親|僕人|真主|兒子|默罕默德|兒子|David|Sanhaajah|著名|為兒子|Aajurroom。|他就此誕生|於|年|672|二|和 70|和六百年|他死了|於|年|723|三|和二十|七百名|從|移民|預言|-|對他的憐憫|真主|最高。|它說:|這次演講|它是|運算式|組成的化合物|有用意義|把在阿拉伯文語言。|我說:|運算式的|(關於演講)|兩個含義/組成的:|其中之一|詞彙/語言，|和第二個|語法。|由|單詞|語言|然後它是|短語|其中|獲取|原因|一種福利，|是否|它是|一個運算式，|或|非|它是|像線一樣|和寫作|和跡象或徵兆|。|對於|語音|語法，|它是必要的|從|那|它滿足了|在它|四|條件或物:|第一; 首先|那|他們是|表達，|和第二次|那|他們是|組成，|和第三個|那|他們是|有意義，|和第四次|那|他們是|主旨|與方法|阿拉伯文。|意義|它被|運算式:|這|他們是|聲音|內含|後|部分|個字母|按字母順序|其中|到職|alef|和結束|與閻|它就像|(Ahmad)|RD|(他寫)|RD|快樂;|然後如果|每|一|從|那些|字數|三|有|發音|與它|這將是|聲音|內含|後|四|按字母順序|信件:|然後，它是標誌或徵兆||愛好|非|被聽到|字數|乘 |一位科學家;|為不|正在|聲音|內含|後|部分|個字母|如果|它是|聽到|乘 |語言學家|演講;|要獲得|受益|有了它。|和意義|正在|組成:|那|他們是|組成|/|兩個字|或|更多，|如:|(默罕默德|是一個旅行者)|RD|(知識|是有益的)|RD|(達到|努力工作|區別)|RD|(為每個|勤奮的人|是的獎勵)|RD|(知識|是更好|什麼|努力|它)|然後每個|個句子|從|那些|個句子|我們叫它|演講中，|和每個|個句子|從它|組成|/|兩個字|或|更多，|然後 word|一|不是|被稱為|語音|乘 |語法學家|除了|當|加入|其他比它|到它|If|它是|加入|其他比它|到它|在這一事實|如示例所示|事先，|或|言外之意，|正如|當|說|給你|某人:|那是|你的哥哥嗎?|然後它說，|默罕默德|因此|字數|被認為是|演講中，|因此|它意味著:|默罕默德|是我的兄弟:|然後它是|於|含義|這句話|組成|/|三|單詞。|和意義|正在|有意義:|那|它會更好|沉默|演講者|對此，|在其中|非|仍然是|攔截器|等待中|對的事情|最後，|然後如果|我說話|(當|來自|老師)|非|它被稱為|那|演講中，|如果|那|運算式|組成|從|三|詞;|這樣，|說話的人|等待|什麼|他會說|之後|此|其中|會的結果|後|到來|老師。|然後當|我說:|(當|來自|老師|將聽|學生)|最愉快的是|這次演講|要獲得|由於採集的意義中獲益。|和意義|正在|主旨|用的語言|阿拉伯文：|那|現在|運算式|已使用|於|語音|從|運算式|其中|坐|阿拉伯文|為符號|在|意義|從|意義|愛好|(他出席)|word|它是語言|阿拉伯文|意義，|它是|發生|出勤|於|時間|過去，|一個字|(穆罕默德)|當然|它是語言|阿拉伯文|意義，|它是|個人|特別是的|被稱為|由那|名稱，|然後當|是說|(出席|默罕默德)|它是|當然|已使用|兩個字|全部|從他們|從什麼|它是語言|阿拉伯文|如反對|什麼|當|口語|用一個詞|從什麼|一種語言|非阿拉伯人:|像波斯人，|和土耳其人，|和柏柏爾人，|和法蘭克人，|然後當然是|非|被稱為|於|使用方式|科學家們的|阿拉伯文|演講中，|即使|它是由調用|人民|語言|其他|講話。|範例|演講|實現|條件:|天氣|是清楚的。|花園裡|是卓有成效的。|新月|是光明的。|天空|是晴朗無雲。|燈號|月亮|在晚上。|接連|勤勞的工作者。|Not|將繁榮|懶惰的人。|沒有|受崇拜的權利|除了|真主。|穆罕默德是|最好的|使者。|真主|是我們的主。|默罕默德|是我們的先知。|一些例子|運算式|一個字:|默罕默德。|阿裡。|亞伯拉罕。|他站在。|從。|一些例子|組成|沒有被|有意義:|城市|亞歷山德里亞。|僕人|真主。|哈德拉毛。|If|只是|人。|當|來自|冬天。|無論|隱藏|兩個面臨。|If|上升|太陽。|問題|在|什麼|提供了|對象|ㄧㄣ|演講嗎?|對象|意義|正在|表達嗎?|對象|意義|正在|作文嗎?|對象|意義|正在|有意義嗎?|對象|意義|正在|主旨|與語言|阿拉伯文？|做例子|五|範例|為什麼|被稱為|含有|定義|演講。
GreatMasterpiece3=種類|演講|它說:|它會解釋|第三:|名詞，|動詞，|顆粒|來|意義。|我說:|運算式|其中|是|阿拉伯人|它所使用的|於|他們的話語|通過對傳輸|給我們|與他們|然後我們|開始說|與它|於|我們的對話|和我們的教訓|我們讀|於|我們的書|我們寫|與它|到|我們的家庭|和我們的朋友，|非|發現/無|一|從它|含有|那|ㄧㄣ|一|從|三|物件:|名詞，|動詞，|粒子。|對於|名詞|於|語言|然後是:|什麼|是指|到|已命名的|中和|術語|意義:|一個字|引用|到|意義|於|本身，|而不是|連接的|用一段時間，|就像:|默罕默德，|阿裡|和男人，|和駱駝，|和河，|和蘋果，|和一杯檸檬茶，|和棍子，|然後每個|一|從|這些|運算式|是指|到|意義|而不是|時間|進入|於|意思，|然後它是|一個名詞。|和|動詞，|它是|於|語言|事件|中和|術語|意義:|一個字|引用|到|意義|於|本身，|它連接|一個|次數|三|-|其中|它是|過去，|到現在，|和未來|-|就像|(他寫了)|然後當然是|一個字|引用|到|意義|-|它是|寫入|還|-|和那|意義|連接|與時間|過去，|就像|(他寫)|然後當然是|引用|到|意義|-|它是|寫入|還|-|和那|意義|連接|與時間|目前，|就像|(寫)|然後當然是|一個字|引用|到|意義|-|它是|寫入|還|-|和那|意義|連接|與時間|未來|這就是|之後|時間|說話。|和實例|這些|運算式:|他説明的協助|他説明助攻|並説明或協助，|他明白|他也理解|和瞭解，|他知道|他知道|知道，|和他坐在那裡|和他坐|而坐，|和他打|和他的命中|和命中。|和動詞|後|三|種類:|過去，|和現在的|和未來:|然後過去:|什麼|是指|到|事件|該發生的事情發生的那次|於|時間|這就是|之前|時間|說話的|就像|他寫道:|和他的理解，|他走了出去，|他聽到，|他看見，|和他談，|和他請求原諒，|和他參加/加入。|和現在:|什麼|是指|到|事件|發生|於|時間|說話的|或|在它以後|就像|他寫道:|他也理解，|和他出去，|他聽到，|他説明的;|和他說話，|和他請求寬恕，|和他參與/聯接。|與該命令:|什麼|是指|到|事件|要求|它完成了|之後|時間|說話，|就像|寫，|和瞭解，|出去，|聽著，|和説明，|和說話，|和請求寬恕，|和參與的聯接。|和|粒子:|然後它是|於|語言:|邊緣|中和|術語|意義:|一個字|引用|到|意義|於|其他比它，|就像|(從)，|然後當然|那|運算式|是一個詞|引用|到|意義|-|它是|開始|-|和那|意義|非|已完成|直到|連接|到|那|word|其他比它，|然後你說:|(我來|從|房子)|舉個例子。|範例|名詞:|書，|鋼筆，|墨水瓶，|/ 摺頁冊|報紙，|人/朋友，|義人，|伊姆蘭，|紙頁|食肉獸/動物，|驢，|狼，|獵豹，|老虎，|檸檬，|橙色，|梨，|水仙，|玫瑰，|這些，|你所有。|範例|動詞:|他旅行|他旅行|旅行，|他說/分支|他說，講話|說/說話，|他已經安全|他是安全的|是安全的|他已接受/高興|他是接受感到高興|接受/很高興，|他一直誠實|他是真實的|說實話，|他一直努力|他工作努力|努力工作|他請求寬恕|他請求原諒|祈求寬恕。|範例|粒子:|從|到/朝/達不包括，|從怎麼樣，|對，|除了/除非/如果不是，|但/然而，|實在/真正/肯定，|對，|是的/事實上，|nay/寧願/但/然而，|當然，|會，|直到，|不 / 沒有，|有沒有，|不 / 永遠不會，|如果 / 不可能的事，|不但是/時，|也許可能是如此/說到|什麼/這，|在未來，/|希望 / 如果只，|如果，|然後，|或。|問題|對象|ㄧㄣ|名詞嗎?|給|該名詞|十|例子。|對象|ㄧㄣ|動詞?|到|幾個|組件|分段|動詞?|對象|ㄧㄣ|現在呢?|對象|ㄧㄣ|該命令嗎?|對象|ㄧㄣ|過去嗎?|給|為動詞|十|例子。|對象|ㄧㄣ|粒子?|給|為粒子|十|例子。
GreatMasterpiece4=告示牌|名詞的|它說:|然後名詞|據悉:|降低/佔有/所有格例|和 noonation，|和進入|阿勒夫|laam，|和顆粒|財產/所有格的情況下，|和他們是:|從|到/朝/達不包括，|和從怎麼樣，|和上/時，|和，|也許 / 很多次了，|和呸，|和 kaaf，|和醋，|和顆粒|誓言，|和他們是:|waaw，|和呸，|和 tah。|我說:|該名詞|標誌|將其區分開來|從|它的兄弟|動詞|與顆粒|存在|之一|從它|或|同意它:|和肯定|提到|作者|-|對他仁慈|真主|-|從|這些|標誌|四|跡象，|和他們是:|降低/佔有/所有格的情況下，|noonation，|進入|阿勒夫|和醋，|和進入|一個粒子|從|顆粒|財產/所有格案例。|作為為|擁有/所有格案例|它是|於|語言:|相對|殿下/海拔，|中和|術語|意義|引用|到|kasra|其中|造成的|功能/主動元素/攝政王|或|這其中|爭議|為它|和那|示例|kasra|raa 的|從|(巴克爾)|RD|() Amr|於|語法|你說:|(我通過|由巴克爾)|你說:|(即|是這本書|Amr)|然後巴克爾|和 Amr:|兩個名詞|與存在|kasra|於|結局|日|一|從他們。|至於|noonation|它是|於|語言:|發聲，|你說:|(聲音|一種鳥)|即:|聲音/放棄某樣東西的聲音|中和|術語|意義|它是|中午|清晰|追蹤|結尾|這個詞的|表達，|和它分離|線條|自-sufficient 嗎不需要|從它|重複|詞根/把母音|含有|控制/精度|用筆，|就像:|默罕默德，|和書，|發言和給我更多單詞/口語，|安靜，|和穆斯林，|和 Fatimas，|同時，|同時，|然後這些|字數|他們每個人都|是名詞，|由徵兆|存在|noonation|於|結尾|日|word|它。|標誌|第三個|/|標誌|名詞:|入口|(基地)|於|第一; 首先|詞，|就像:|男人，|小男孩朋克|和這匹馬，|和這本書，|造的房子，|和學校，|然後這些|字數|他們每個人都|是名詞，|由入口|alef 的|和醋|於|它的前面。|標誌|第四:|入口|粒子的|從|顆粒|財產/所有格的情況下，|就像:|(你去了|從|這房子|到|學校)|然後每個|從|(房子)|RD|(學校)|是名詞，|由入口|粒子的|擁有/所有格案件的|在他們身上|而存在|(基地)|於|他們的起點。|和顆粒|擁有/所有格案件的|他們是:|(從)|和由它|意義:|從它|開始|就像|(我走過|從|開羅)|RD|(轉入)|和從|它的意思|結局，|就像|(我走過|到|亞歷山德里亞)|RD|(從)|和從|它的意思|放棄，|就像|(我扔/火|箭頭|從|弓)|RD|(上)|和從|它的意思|正在/升以上，|就像|(我爬上|在|這座山)|RD|(中)|和從|它的意思|狀語，|就像|(水|在其中|壺)|RD|(幾個)|和從|它的意思|減少，|就像|(幾|男人|大方|我見過)|RD|() baa|和從|它的意思|超過，|就像|(我通過|由谷)|RD|() kaaf|和從|它的意思|相似性，|就像|(非常漂亮|像滿月)|RD|(醋)|和從|它的意思|擁有，|就像|(錢|屬於穆罕默德)|() 1|和規範，|就像|(門|房子屬於 /)，|(在墊子上|/ 屬於清真寺)|和老有所為，|就像|(所有的稱讚是由於|安拉)。|從|顆粒|財產/所有格案例:|顆粒|誓言，|和他們是|三|字母。|第一:|waw|它是|非|進入|除了|在|名詞|表觀/可見，|就像|(由真主)|就像|(由山。|() 1|和一本書|刻)。(52: 1-2)|就像|(由國際體聯|和橄欖。|() 1|和山|Sinai)(95:1-2)。|和第二個:|Baa，|而不是|有關由|語氣詞|無 / 其他比|語氣詞|事實上|進入|後|名詞|表觀/可見，|就像|(由真主|我會努力工作)|和後|代詞，|就像|(由你|我會打敗|最懶惰的一個)。|和第三個:|taa，|而不是|進入|除了|後|語氣詞|威嚴的|就像:|(和由真主|我肯定會打擊計畫|你的 idols)(21:57)。|問題|對象|跡象|名詞嗎?|對象|意思是|擁有/所有格案件的|語言詞彙|和用語嗎?|對象|ㄧㄣ|noonation|語言|和用語嗎?|後|什麼|事||顆粒|表示:|從|laam|kaaf，|很少有人，|與，|在嗎?|對象|其中|與有關的|waaw|誓言|通過輸入|在上面|從|標誌|名詞嗎?|對象|其中|與有關的|taa|誓言|通過輸入|在上面嗎?|舉例說明|baa 的|誓言|兩個例子|不同。|範例|請參閱|名詞|有哪些|於|例子|之後:|含有|提及|標誌|其中|你明白|與它|其名詞:|量的名稱|真主|最仁慈|最仁慈。|所有的讚美和感謝|是因為真主|耶和華|世界的...(1:1-2)|當然|禱告|被遺忘|從|污穢|與惡......(29)|時報 》|當然|人類|是在|的損失......(103-2)|和你的神|是神|一...(第 163 節)|最仁慈|所以問問|關於他|一個全意識到...() 25:59|當然|我的祈禱|和我的犧牲的儀式|和我的生活|我的死亡|真主確是|耶和華|世界，|否|夥伴|有他，|與此|我已吩咐，|和我|第一; 首先|穆斯林。(162-163)
GreatMasterpiece5=標誌|動詞的|它說:|和動詞|據悉，|與肯定|見過，|RD|(會)|及 taa|女性氣質|母音-少。|我說:|是尊敬|動詞|從|它的兄弟|名詞|與顆粒|四|跡象，|當|你找到了|在它|一|從他們，|或|你看看|關於它|在它之前|你明白|它|是一個動詞:|第一:|(肯定)|和第二次:|(看到)|和第三:|(會)|和第四次:|(taa|女性氣質|母音-少)。|對於|(當然):|然後輸入|後|兩個跡象|從|動詞，|和他們是:|過去|和現在。|然後當|進入|後|動詞|過去式|它指示|後|一|兩層含義|-|兩個是|確認|和近似。|-|然後示例|指示它|後|確認|說|最高:|(當然|成功|是 believers)(23:1)|和說|陛下|那將會:|(最肯定|很高興|真主|含有|believers)(48:18)|和我們說:|(事實上|出席|默罕默德)|和我們說:|(事實上|旅行|哈立德)|和實例|該值指示|後|逼近|說|一位即將執行的開始|禱告:|(幾乎怎麼樣|就要開始了|禱告)|對你說:|(幾乎怎麼樣|是要設置|sun)(1)。|當|進入|後|動詞|存在|它指示|後|一|兩層含義|此外:|-|兩個是|減少，|增加|-|然後為|其適應證|後|減少，|然後就像|:|(很少/很少/偶爾|說出真相|說謊的人)|對你說:|(很少/很少/偶爾|是慷慨|吝嗇的人)|對你說:|(很少/很少/偶爾|成功|最懶惰的一個 / 人)。|和|其適應證|後|增加，|然後就像|你說:|(總是|獲得|努力工作|他的目標)|和你說:|(總是|沒有|虔誠的人|好)|和這句話|詩人:|永遠|到達|慢的人|部分|他的目標|和總是|將|含有|急人|犯錯的錯誤|和|所見|並將:|然後進入這兩個|後|動詞|存在|只，|和他們是|提到|後|未來，|及其意義|未來|除了|那|(看到)|我說|未來|從|(將)。|然後為|所見|然後就像|它說|大多數 High\:|(很快就會說|愚蠢的|從|people)(2:142)，|(很快就會說|給你|successors)(48:11)|和|(會)|然後就像|他說|最高:|(然後將|給你|你的主|content)(93:5)，就可以|(將|我們給他們展示|fire)(4:56)|([阿拉] 意志|給他們|他們的工資 [在判斷 day])(4:152)。|和|taa|女性氣質|母音少:|然後輸入|後|動詞|過去式|沒有|其他比它;|和目的|它的|是的徵兆|後|那|名詞|其中|分配|那|動詞|為它|是的女性氣質;|是否|它是|活躍，|就像:|(說|阿伊莎|母親|信徒)|或|是|副|活動，|就像|(地毯|我們的房子|以傳播/副檔名)。|目的是|它|是母音少|於|原始|其完備性|然後不|受損的傷害|其 vowelization|為意外|除掉了|從|會議|兩個 sukoon|於|就像|這句話|最高:|(和她說|出去|從 them)(12:31)，|(和她說|命令|到 Pharaoh)(28:9)，|(他們說|我們來|obedient)(41:11)。|從那|前面提到的|變得清晰|給你|那|標誌|動詞的|其中|提到他們|作者|後|三|部件:|第部分|具體來說|進入|後|過去，|它是|taa|女性氣質|母音少|和部分|具體來說|進入|後|目前，|它是|所見|並將|和部分|共用|他們兩個之間|它是|當然可以。|和肯定|省略|標誌|動詞的|命令，|它是|說明|後|要求|含有|它接受|yaa 的|第二人|或|中午|重點|就像|(設置)|RD|(坐)|RD|(寫)|RD|(看起來)|然後當然|這些|字數|四|種種跡象表明|後|請求|尋找|站立|和坐|和寫作|看，|含有|驗收|yaa 的|第二人|於|就像|(你的立場，|和你坐)|或|含有|驗收|中午|重點|於|示例|(讓我們寫，|讓我們看看|到|什麼|好處)。|問題|對象|現在|標誌|動詞?|到|幾個|組件|劃分|標誌|動詞?|對象|現在|標誌|其中|標識|與動詞|過去嗎?|多少|標誌|正在確定|與動詞|本?|對象|現在|標誌|有哪些|共用|介於|過去式|和現在嗎?|對象|現在|含義|其中|表示|在上面|(當然) 嗎?|後|什麼|事情|表示|taa|女性氣質|母音-少嗎?|對象|ㄧㄣ|意義|其中|指示|在上面|所見|和會嗎?|和什麼|區別是|他們兩個之間?|如何|你明白嗎|標誌|區分|動詞|命令嗎?|給|兩個例子|/|(肯定)|該值指示|後|肯定，|讓|兩個例子|被|在他們|(幾乎怎麼樣)|該值指示|後|逼近，|讓|兩個例子|被|(當然幾乎/怎麼樣)|於|其中兩個之一|該值指示|後|逼近|中和|其他|該值指示|後|確認，|讓|兩個例子|被|(很少/很少/常)|於|其中兩個之一|該值指示|後|減少|和了|於|結尾|該值指示|後|增加，|讓|示例|一|允許|在它|(很少/很少/常)|那|被|適應證|後|減少|和增加，|讓|持續|(當然幾乎/怎麼樣)|與示例|一|允許|在它|那|被|適應證|後|逼近|或|確認，|和標準|於|那|示例|其中|是|該值指示|後|確認|而|是|該值指示|後|逼近。|演習|區分|名詞|和動詞|其中|在|短語|給出，|辨析|每|型別|/|類型|動詞，|含有|一提|標誌|其中|顯示|與它|後|名詞化結構|這個詞的|或|其實際的/有效，|和他們是:|(如果|你表明|好|或|隱藏它|或|再說一遍|從|進攻|然後當然|真主|ㄧㄣ|曾經赦免|和 Competent)(4:149)|(|事實上|薩法|和瑪律瓦|來自|標誌|真主||所以無論誰|使主要的朝聖之旅|到房子|或|執行次要朝聖|然後不|責備|在他身上|那|他 circumambulates/走之間|他們兩個||和誰|志願者|好|然後當然|真主|感謝|和 Knowing)(2:158)。|說|祈禱|真主|在他身上|與和平:|將會有|風暴|一坐|在它|更好|從|一個站|和一個站|在它|更好|從|是走|和一個走|在它|更好|從|一個運行|誰|有恩典|從它|必須保護自己|和誰|發現|在它|住房|或|避難|然後避難|有了它。
GreatMasterpiece6=粒子|它說:|粒子|it|非|不接受|與它|適應證|名詞的|而不是|適應證|名詞。|我說:|尊敬的|粒子|從|它的兄弟|名詞|和動詞|與那它|非|不接受|進入|標誌|從|標誌|名詞的|上一步|而不是|其他比它|在其上，|正如|非|不接受|進入|標誌|從|標誌|動詞的|其中|我們以前有|解釋|而不是|其他比它|在上面。|和它的示例|(從)|RD|(am/是/是/有/有/已/將)|RD|(沒有)|這些|字數|三|是的粒子|因為他們|非|允許做|Al-|而不是|noonation，|而不是|允許|進入|粒子|所有格/所有格案件的|在其上，|然後不|接受|那|是說:|從，|而不是|那|是說:|從，|而不是|那|是說:|到|從|和像那樣|與其他|顆粒，|和也|非|接受|那|進入|在上面|所見，|而不是|(會)|而不是|taa|女性氣質|母音-少，|而不是|() certainly\almost\rarely\often|而不是|其他比它|從什麼|它是|標誌|後|那|這個詞|是一個動詞。|演習|1-|付諸表決|每|word|從|單詞|給出了|於|語音|有意義|好|沉默/停止|上它。|棕櫚樹。|大象。|他睡著了。|他的理解。|花園裡。|土地/地球。|水。|他吃。|果實。|果實。|他的收成。|他學習。|2-|付諸表決|於|這個地方|空閒|從|每|示例|從|例子|追蹤|word|完成|與它|意思，|請參閱/解釋|之後|那|數量|部分|日|示例中，|和意義|日|部分。|(仲裁)|他能記住|......|一課。|(B)|......|土地/地球。|(C)|他游泳|......|於|早晨。|(代理)|它航行|......|於|海洋。|(E)|去了|......|於|空氣。|(F)|他增加|......|與國家|埃及。|(G)|父親|......|後|他的兒子。|(H)|那個男孩|有禮貌|......|() i|......|魚兒|於|水。|(J)|阿裡|花/花。|3-|請參閱|動詞|過去，|和動詞|目前，|和動詞|命令，|與不可數名詞，|和顆粒，|從|標誌|之後:|非|已分配|真主|報信人|從|兩顆心|於|他 body(33:4)|......|是渴望|聰明的人|後|快樂|他的主|......|培養|你的世界|像你一樣|將活|永遠|......|努力|那個年輕人|對的事情|永不|他會實現它，|永不|你將會實現|榮耀|直到|你品味舔|耐心/蘆薈|......|If|你們是誠實|你終將獲勝|......|當然|是成功|誰淨化自己，或使它成長|和肯定|是一個失敗|誰埋葬自己或它的特技。
GreatMasterpiece7=它說:|(門|變化)|拐點|它是:|它改變了|結局|詞的|由區別|是活動元素攝政王|進入|在上面|表觀|或|假設。|我說:|拐點|它是|兩層含義:|兩個第一|詞彙語言|和其他|術語。|對於|意義|於|語言|然後是:|披露|和博覽會，|你說:|我表達清楚|這是|於|我自己內心的我，|當|它被披露|和證明所示。|和|它的意思|於|術語|然後它是|什麼|被提及|作者|他的演講|正在變更|它的結局|這個詞的|-|等/到結尾。|和預期|從|(更改|結尾|這個詞)|更改|的狀態|結束|這個詞，|而不是|它意味著|那|它想要|更改|實際/自我|結局，|然後當然|結局|這個詞的|本身|非|改變，|更改|國家|結束|這個詞的|短語|那|其變化|從|主格|到|賓格|或|所有格:|實際/文字|或|假設/裁決|和會|那|變更|原因理由|正在變更|攝政王/積極的元素的|從|攝政王/主動元素|需要|主格|後|有效性|或|喜歡它，|到|結尾|需要|賓格|後|動詞|或|喜歡它，|等|上。|舉個例子|當|你說:|(出席|默罕默德)|然後默罕默德:|主格，|然後真正是|被動語態|元素|需要|主格|後|有效性，|和那|功能|它是|(他出席)|然後當然|你說:|明白了|默罕默德|正在變更|條件|最後一個|(穆罕默德)|到|賓格;|為改變|行動|與行動|最後一個|需要|賓格|它是|(見)，|然後當|你說:|(我贏了|與默罕默德)|更改|條件|在它以後|到|所有格|為改變|行動|與行動|最後一個|需要|所有格|它是|baa。|和什麼時候|你的思考|於|那|示例|顯示|給你|那|結尾|這個詞的|-|它是|扁豆|從|默罕默德|-|非|對它，任何更改|和那|其中|更改|它是|美國|它的結局:|那麼肯定你|將會看到|主格|於|該示例|第一，|和賓格|於|該示例|第二，|和所有格|於|該示例|第三個。|和那|變更|從|條件|主格|到|條件|賓格|到|條件|所有格|它是|拐點|含有|作者|和從|它去|他的思想學派，|和那|母音|三|-|其中|它是|主格|和賓格|和所有格|-|它是|標誌|和州|後|拐點。|和喜歡|名詞|於|那|動詞|目前，|然後不|你說:|(遊記|亞伯拉罕)|然後旅行:|一個動詞|存在|主格;|它是免費的|從|使用中的元素|需要它|賓格|或|使用中的元素|需要它|命令/斜的情況下，|然後當|你說:|(不會的|傳導|亞伯拉罕)|更改|條件|(他旅行)|從|主格|到|賓格|正在變更|使用中的元素|與活躍的元素|其他|要求|賓格|它是|(不會)|然後當|你說:|(沒有|傳導|亞伯拉罕)|它改變了|條件|(他旅行)|從|主格|或|賓格|到|命令/斜的情況下，|更改|活動元素|與活躍的元素|其他|要求|命令/斜的情況下，|它是|(沒有)。|和知道|那|此|變更|劃分|到|兩個部分:|口述/語音，|並暗示本應。|然後為|口述/語音|和它是:|什麼|非|防止|從|送電|它的|防止|就像|你看見|於|詞根|扁豆|從|(穆罕默德)|和詞根|raa 的|從|(他旅行)。|和|暗示本應:|它是|什麼|防止|從|發音|與它|防止|從|不可能，|或|困難，|或|適宜性;|你說:|(調用|那個男孩|法院和法官|和我的僕人)|然後調用:|主格|免費|從|賓格|與命令/斜案例、|和男孩:|主格|為正在|活躍，|法院和法官|和我的僕人:|這兩個主格|因為他們兩個|耦合|後|活動元素|主格|因為|dammah|非|出現|於|結尾|這|詞，|它的不可能性|於|(男孩)|這是個難題|於|(調用)|中和|(法官)|和原因|適用性|yaa 的|第一人|於|(我的僕人);|然後你有|dammah|隱藏|後|結尾|這個詞的|防止|從|其表觀/明顯|不是可能，|或|困難，|或|放置|這個地方|與母音|合適。|你說:|不會|很高興|那個男孩|法院和法官|和我的僕人)|和你說:|(當然|那個男孩|和我的僕人|都是贏家)|和你說:|(我通過|那個男孩|和我的僕人|法院和法官)。|然後不|是|最後一次|阿勒夫|正確/必要|暗示本應|在上面|全部|母音|為不可能的事|並要求|名稱|已結束|由阿勒夫|有限公司|示例|那個男孩|與棍子|和情報|和手磨機|和知足。|而不是|是|它的結局|yaa|正確/必要|暗示本應|在上面|dammah|和 kasra|為困難/沉重|和電話|名稱|終止|以 yaa|不完美|和明顯明顯|在上面|fathah|對於明度，|就像:|法官，|邀請人，|和攻擊者，|與轉輪，|後起之秀，|和投擲者。|Not|是|著魔|到|yaa|第一人|暗示本應|在上面|母音|他們每個人都|適當性，|就像:|我的僕人，|和我的書，|和我的朋友，|和我的父親，|和我的老師。
GreatMasterpiece8=反對|拐點/大寫結尾|不是變性/結構，|和會變得清晰|每|一|從他們|完成|清晰度|原因|解釋|最後，|和肯定|已省略|作者|解釋|結構/不變性|和我們|解釋|給你|後|方式|其中|解釋|與它|拐點/案件的結局，|然後我們說:|結構/變性/不變/建設|有兩層含義:|第一; 首先|是詞法作用域|和第二個|術語:|然後為|它的意思|於|語言|然後它是|短語|那|是把|東西|後|其他的東西|後|側邊|探索|與它|穩定/穩固性|和必要性。|和|它的意思|於|術語|然後它是|含義|結局|這個詞的|條件|一|其他|攝政王|和沒有|缺陷，|和那|像的含義|(多少)|RD|(從)|母音-少，|和像意蘊|(這些)|RD|(一個女人的名詞)|RD|(昨天)|kasra，|和像意蘊|(前)|RD|(無論)|damma，|和像意蘊|(在那裡)|RD|(如何)|罰的罵。|從|這些|澄清|你知道的|那|標題|結構/不變性|四:|母音-少，|和 kasra，|和 damma，|和罰的罵。|前後|解釋|每個|這些|事情|非|困難|在你身上|知識|拐點|結構/不變，|然後如果|拐點:|非|其他|條件|結束|運算式|或|正在變更|由原因|因素，|和結構/不變:|非|有必要|它的結局|條件|一|其他|使用中的元素|和弱點。|演習|請參閱/解釋|拐點|與它的語法，|結構/不變，|從|字數|發生|於|短語|給出:|說|阿拉伯人:|真主|補償|什麼|已終結|人/人類，|和時間|毀壞|什麼|他們收集了，|和許多/頻繁|從|死亡|在他們身上|搜索|生活，|和生活|其原因|曝光/面對|死亡。|問|歐麥爾|兒子|哈塔卜的|阿姆拉|兒子|Madeeakarib|從|這場戰爭，|然後說:|對他說:|它是|苦澀|它的味道，|當|變得更少|從|暴力，|誰|是病人|在它|將已知，|和誰|是弱|從它|將被銷毀。|(由早上的陽光|() 1|和夜晚|當|它涵蓋了|() 2|非|已經忘了你|你的主|而不是|離棄了你|() 3|和來世|是更好|給你的|於|第一次)|當然|超越|告訴我|揭示了|真相|在什麼|你報告|那|榮譽|於|運輸|當|睡著了|沒有經驗|於|中東|夜的|然後看|然後|為閣下|我還流鼻涕|和小茴香|當|您|不會|縮短|從|無知|與背叛|我曾經是|忍耐|或|你降臨|無知|有耐心的人|後|權限|騎士精神的|大多數|從|病人|後|疼痛|需要，|與羞愧|貧窮的|禁止|從|榮耀|耐心的|正如|那|榮耀|財富|防止|從|慷慨大方|公平。|問題|對象|ㄧㄣ|拐點/案件的結局嗎?|對象|ㄧㄣ|結構/不變性?|對象|ㄧㄣ|屈?|對象|ㄧㄣ|結構/不變嗎?|對象|意思是|(更改|其他|字)?|到|幾個|組件|劃分|更改嗎?|對象|ㄧㄣ|變化|表達嗎?|對象|ㄧㄣ|變化|應該嗎?|對象|是的原因|變化|應該嗎?|提及|兩個原因|用什麼|防止|發音|與母音。|給我|三|範例|演講|有用，|因此|它是|於|每個|示例|一個名詞|拐點|與詞根|暗示本應|防止|從|其明顯|不可能的事。|給我|兩個例子|演講|有用|於|每個|一|從他們|名詞|拐點|與詞根|暗示本應|防止|從|其明顯|困難。|給我|三|範例|演講|有用|於|每|示例|與它|一個名詞|結構/不變。|給我|三|範例|演講|有用|它是|於|每|示例|與它|一個名詞|屈|與詞根|暗示本應|防止|從|其明顯|恰當。
GreatMasterpiece9=部分|拐點|它說:|和它的零件|有四個:|主格，|和賓格|和所有格，|與命令/斜案例、|然後為名詞|從|那|主格，|和賓格|和所有格，|而不是|命令/斜案例|在它，|然後為動詞|從|那|主格，|和賓格|與命令/斜案例、|而不是|所有格|在它。|我說:|種類|拐點|其中|發生|於|名詞|和動詞|一共|四:|第一:|主格，|第二種:|賓格的情況下，|第三:|所有格，|第四:|命令/斜，|並為每個|一|從|這些|組件|四|意義|於|詞彙，|和意義|於|術語|下降了。|對於|主格|然後它是|於|詞彙:|殿下|和高程，|它是|於|術語:|更改/變化|排除|它是已知的|damma|和什麼|可能在的地方|它，|和公認|附近的|什麼|地點|從|damma|於|分離|完整|If|遺囑|真主，|和位於|主格|於|每個|從|名詞|和動詞，|就像:|(站立|阿裡)|RD|(唱|白頭翁/夜鶯)。|和|賓格|然後它是|於|詞彙:|解決|和直線度，|它是|於|術語|正在變更|特殊|它的標誌|是罰的罵|和什麼|可能在的地方|在其上，|和存在|賓格|於|每個|從|名詞|和動詞|此外，|就像:|(也不會|我愛|懶惰)。|和|所有格|它是|於|詞彙:|降低/自卑，|它是|於|術語:|正在變更|特殊|標誌|kasra|和什麼|可放|在其上，|而不是|ㄧㄣ|所有格|除了|於|名詞，|就像:|(我遭受感到疼痛|從|懶惰的人)。|和|命令的情況下|它是|於|詞彙:|切斷，|中和|術語|正在變更|特殊|標誌|sukoon|和什麼|可放|在其上，|而不是|ㄧㄣ|命令的情況下|除了|於|動詞|現在時態|就像:|(並不|贏得|懶惰的人)。|然後當然|顯示|給你的|那|類型|拐點/案件的結局|後|三|部件:|組件|共用的類型|介於|名詞|和動詞，|和他們是|主格|和賓格，|和部分|相關|以名詞，|它是|所有格，|和部分|相關|用的動詞，|它是|命令的情況。|問題|是什麼|類型|拐點?|對象|ㄧㄣ|主格|詞法上|和術語嗎?|對象|ㄧㄣ|賓格|詞法上|和術語嗎?|對象|ㄧㄣ|所有格|詞法上|和術語嗎?|對象|ㄧㄣ|命令的情況下|詞法上|和術語嗎?|對象|類型|拐點/大寫結尾的|有哪些|共用|在它|名詞|與動詞?|對象|其中|有關|與它|名詞|從|標誌|屈折變化/案件的結局嗎?|對象|其中|有關|與它|動詞|從|標誌|屈折變化/案件的結局嗎?|給|四|範例|為每個|從|名詞|主格，|和動詞|賓格|和名詞|所有格，|和動詞|命令的情況。
GreatMasterpiece10=它說:|(章|第一個|標誌|拐點/案件的結局)|為主格|於|四|體征:|damma，|和 waw|和阿勒夫|到中午。|我說:|你就能|到|瞭解|那|這個詞|是主格|與存在|跡象|於|它的結局|從|四|體征:|一|從它|原件/源，|它是|damma，|和三個|分支|從它，|和他們是:|waw|和阿勒夫|到中午。
GreatMasterpiece11=地方/職位|damma|它說:|然後為|damma|然後它是|標誌|為主格|於|四|職位:|名詞|單個表單，|和複數|壞了，|和複數|女性|聲音，|和動詞|存在|其中|什麼也沒有|附加與聯繫|與它的結局|所有的東西。|我說:|ㄧㄣ|damma|標誌|後|主格|這個詞的|於|四|職位:|位置|第一:|名詞|奇異，|和位置|第二:|複數形式|壞了，|和位置|第三:|複數|女性|聲音，|和位置|第四:|動詞|存在|其中|什麼都不|已連接|與它|阿勒夫|二元性|而不是|waw|所述多個，|而不是|是啊|解決，|而不是|中午|佐證|將它光|或|重，|而不是|中午|女性的特質。
GreatMasterpiece12=和|名詞|單數|然後是打算這麼|與它|在這裡:|什麼|還沒有|二元性|而不是|多元化|而不是|加入|給他們|而不是|從|名詞|五:|是否|我有|意味著意欲 /|與它|男性|例如:|默罕默德，|阿裡|和哈姆紮，|或|是|意味著意欲 /|與它|女性氣質|例如:|法蒂瑪，|和阿伊莎，|和贊，|和天氣|她是|damma|可見明顯|像什麼|在其中|範例:|(出席了|默罕默德)|RD|(遊記|法蒂瑪)，|或|她是|應該|就像:|(出席|那個男孩|法院和法官|和我的兄弟)|就像:|(結婚|晚上|和拿俄米)|然後如果|(穆罕默德)|以及|(法蒂瑪)|是兩個主格|和標誌|他們主格的|damma|很明顯，|RD|(男孩)|和它的例子|(夜)|RD|(俄)|是主格，|和標誌|主格的|是 damma|應該|後|阿勒夫|防止|從|其可見/明顯|不是可能，|RD|(法官)|是主格，|和標誌|它主格的|是 damma|應該|後|是啊|防止|從|其可見/明顯|困難，|RD|(哥哥)|是主格，|和標誌|它主格的|damma|應該|後|什麼|之前|是啊|第一人|防止|從|其可見/明顯|詞根|適當。
GreatMasterpiece13=取代|waw 的|從|damma|它說:|和|waw|然後是|標誌|為主格|於|兩種情況:|於|複數|男性|聲音，|中和|名詞|五、|和他們是:|你的父親，|和你的兄弟，|和你的公公，|和你的嘴，|和擁有化學武器的國家|財富。|我說:|是|waw|標誌|後|主格|單詞|於|兩種情況:|第一:|複數|男性|聲音，|與案例|第二:|名詞|五。|對於|複數|男性|聲音，|它是:|一個名詞|該值指示談到|後|結束|從|兩個，|隨著增加|於|它的結局，|它是有效|免費|從|此|另外，|和加入|到喜歡|它，|就像:|(很高興|那些被留下 behind)(9:81)，|(但|那些人是堅定|於|知識|從他們|和 believers)(4:162)，|(而且如果|恨/不喜歡它|criminals/guilty)(8:8)，|(如果|有|從你|二十|steadfast)(8:65)，|(和其他人|已確認|他們的 faults)(9:102)。|然後每個|從：|(那些被留下的人)|RD|(那些人是堅定)|RD|(信徒)|RD|(罪犯/有罪)|RD|(堅定/病人)|RD|(其它)|複數|男性|聲音，|指的|後|多|從|兩個，|並且在它|另外|於|它的結局|-|它是|waw|到中午|-|它是|有效|免費|從|此|增加，|非|查看|給你的|你說:|遺棄的人，|和一個人是堅定的|和一個信徒，|和刑事/有罪之一，|和病人/堅定之一，|和另一個，|和每個|運算式|從|運算式|複數|出現次數|於|此|標誌|主格，|和標誌|它主格的|waw|更換|從|damma，|與此|中午|其中|之後|waw|替代產品|從|tanween|於|你說:|(負責人)|和其他比它，|它是|名詞|奇異。
GreatMasterpiece14=取代|阿勒夫|從|damma|它說:|和|阿勒夫|然後是|標誌|為主格|於|雙|名詞|特別。|我說:|是|阿勒夫|標誌|後|主格|這個詞的|於|案例|一個人，|它是|名詞|雙，|就像|(出席|這兩個朋友)|然後這兩個朋友:|雙，|它是|主格|因其|是攝政王，|和標誌|它主格的|更換|阿勒夫|從|damma，|到中午|替代|持續|noonation|於|你說:|一位朋友，|它是|一個名詞|奇異。|和雙|它是:|每|名詞|該值指示|後|兩個男性|或|兩個女性，|隨著增加|於|它的結局，|就足夠了|此|增加|含有|合取|和附加，|就像:|走近|兩個火星叔叔，|和兩名印度人)|然後兩個火星叔叔:|運算式|該值指示|後|二|名詞|每個|一|從它|歐麥爾|有理由|存在|新增|於|它的結局，|與此|新增|它是|阿勒夫|到中午，|和它|就足夠了|從|參與|帶有 waw|合取|和細化|名詞|因此|你說:|(出席|歐麥爾|和歐麥爾)|和像那樣|兩個印第安人;|它是|運算式|該值指示|後|兩個女性|每|一|從這兩個|其名詞|印度人，|和原因|它指示|後|那|新增|alef 的|到中午|於|該示例中，|以及存在|alef 的|到中午|夠你|那|參與|帶有 waw|合取|和細化|名詞的|因此|你說:|(出席|印度|和印度)。|演習/練習|1-|回覆|每|複數|從|複數|追蹤|到|奇異的男性，|RD|然後|奇異的女性，|然後|放|每個|雙|於|字數|有用有益|因此|是|主格，|和在這裡|佔有人|複數形式:|駱駝，|大象，|劍，|坦克，|油墨罐|星星，|花園，|花園，|論文，|麵包店，|鞋，|襯衫，|醫生，|路線的方法，|可敬，|椅子/座位，|科學家，|牆壁，|windows，|門，|windows，|少女們懷念，|弓，|事項/事務，|國家，|國家，|蘋果。|2-|名次|每個|一|從|對偶形式|給出了|於|語音|很有用:|這兩位科學家，|兩位領導人，|這兩兄弟中，|兩個硬工人，|兩個指南，|這兩個朋友，|在兩座花園，|兩個女孩，|兩本書中，|兩個的尊敬，|這兩個國家，|兩堵牆，|兩位醫生，|兩個事項/事務，|兩個騎馬的|兩個椅子/席位，|兩個處女，|兩把劍，|這兩個傑出的|這兩封信，|兩位家長，|這兩個國家，|在兩座花園，|每個進入兩個的方式，|兩個蝴蝶結，|兩個國家，|兩扇門，|兩個蘋果，|兩顆星。|3-|付諸表決|於|這個地方|空白/空|從|標誌|給出了|運算式|雙:|(仲裁)|旅行|......|到|埃及|看|它的紀念碑。|(B)|出席|我的兄弟|和他一起|......|所以我對他們感到很榮幸。|(C)|包含|哈立德|......|和他命名|兩個之一|默罕默德|和他命名|其他|阿裡。|問題|內|幾個|案件|是|阿勒夫|標誌|後|主格|這個詞嗎?|對象|ㄧㄣ|雙嗎?|車廠|雙表單|兩個例子:|第一; 首先|男性，|和其他|女性。
GreatMasterpiece15=取代|中午|從|damma|它說:|和|中午|然後是|標誌|為主格|於|動詞|目前，|當|已連結|與它|代名詞|二元性|或|代名詞|所述多個，|或|代名詞|女性氣質|每秒處理的人。|我說:|是|中午|標誌|後|那|word|其中|它是|於|它的結局|主格|於|案例|一個人，|它是|動詞|現在時態|連接的|到|阿勒夫|第二個男性|或|第二次的女性，|或|已連結|到|waw|複數形式|男性，|或|已連結|到|是啊|女性氣質|每秒處理的人。|和|所附|到|阿勒夫|第二個男性|然後就像|(這兩個朋友|將旅行|明天)，|就像|(你們兩個|將旅行|明天)，|然後我們說:|(這兩個出差旅行)|和喜歡|(你們兩個出差旅行)|一個動詞|現在時態|主格，|免費從粒子|從|賓格|與命令的情況下，|和標誌|主格的|是的存在|中午，|和阿勒夫|第二個|活躍的元素，|結構|後|sukoon|於|地方|主格。|然後當然|你看看|那|動詞|現在時態|已連結|到|阿勒夫|第二個|5 月|一直|已啟動|與閻|用於指示|後|三人|像什麼|於|該示例|第一，|和 5 月|一直|正在啟動|與 tah|用於指示|後|第二人|愛好|於|該示例|第二次。|和|所附|到|阿勒夫|女性雙|然後就像:|(兩個印第安人|將旅行|明天)，|和一樣:|(你們兩個|O 兩個印第安人|將旅行|明天)，|然後她是 / 你出差旅行|於|兩個例子:|一個動詞|現在時態|主格|與證據|中午，|和阿勒夫|是活躍的元素，|結構|後|sukoon|於|地方|主格。|並且從他們|你知道的|那|動詞|現在時態|已連結|到|阿勒夫|這第二位女性|非|是|正在啟動|除了|與 tah|用於指示|後|女性氣質|活動元素的|是否|是|三人|如示例所示|第一，|或|是|存在|每秒處理人|如示例所示|第二次。|和|所附|到|waw|所述多個，|就像|(男人|真誠|他們|誰|完成/必須做|他們的職責)，|就像|(你所有|O 我的人|完成/必須做|你的職責)|然後他們履行/必須做|-|和喜歡它|你滿足嗎/你必須做|-|一個動詞|現在時態|主格，|和標誌|它主格的|是證據|中午，|和 waw|所述多個|活躍的元素，|結構|後|sukoon|於|地方|主格。|並從它|你知道的|那|動詞|現在時態|已連結|到|此|waw|當然|是|正在啟動|與閻|用於指示|後|第三次的人，|像什麼|在其中|該示例|第一，|和肯定|是|正在啟動|與 tah|該值指示|後|每秒處理的人，|像什麼|在其中|該示例|第二次。|和|所附|到|是啊|女性氣質|每秒處理人|然後就像|(你|O 後腿|知道|你的職責)|然後你知道:|一個動詞|現在時態|主格，|和標誌|它主格的|是的證據|中午，|和嚴|女性氣質|每秒處理人|是活躍的元素，|結構|後|sukoon|於|地方|主格。|而不是|是|動詞|已連結|到|此|是啊|非|正在啟動|與 tah，|它是|該值指示|後|女性氣質|積極元素。|所以總結|給你的|那|已連結|到|阿勒夫|是|正在啟動|與 tah|或|有呀，|金及附加|到|waw|諸如此類|是|正在啟動|與 tah|或|有呀，|金及附加|到|是啊|非|是|正在啟動|除了|與 tah。|和它的例子:|兩人男性站，|和你兩兩的女性立場，|他們男性立場、|和你所有男性的立場，|和你女性的立場，|和命名|這些|範例|(動詞|五)。|練習/演習|1-|付諸表決|於|每|地方|從|地方|自由/空|一個動詞|從|動詞|五|發生，|然後|參照|到|什麼|事情|表示|信件|現在時態|其中|它開始|與它:|(仲裁)|男孩子們|......|於|這條河。|(B)|父親|......|對|他們的兒子。|(C)|你們兩個|O|年輕的男孩|......|速度慢。|(代理)|這些|男人|......|於|欄位。|(E)|您|阿贊|......|你的職責。|(F)|兩位年輕的女士|......|那個士兵。|(G)|您|O|男人|......|你的國家。|(H)|您|阿薩阿德||用球。|2-|使用|每|動詞|從|動詞|給出了|於|一個句子|有意義/有用:|兩個女性 / 你們兩個玩，|女性的你，|所有男性都培養你，|兩個女性 / 你們兩個收穫，|兩個女性 / 你們兩個談，|你所有男性走，|他們男性游泳，|所有男性的為您服務，|兩個女性 / 你們兩個生產，|你所有女性同意接受。|3-|付諸表決|含有|每|word|從|字數|給出了|一個動詞|從|動詞|五|發生，|和使|含有|複數形式|語音|有意義/有用:|這兩個學生，|兩個小男孩，|而那些穆斯林，|男子|誰|保留|他們的職責，|您|O|年輕的女孩，|您|O 人，|這些|同學們，|If|你反對|訂單|真主。|4-|請參閱|主格|與 damma，|和主格|alef|和主格|帶有 waw|和主格|證據|中午，|含有|引用|每|一|從他們，|從|引用|這個詞|收入|於|標誌|給出:|書籍|萬王之王|他們的缺點|有保障|與他們，|和耳洞的許可權|通知，|和自己的舌頭|目睹了，|勇氣|是一種自然的衝動|已放置|真主|為誰|他所意欲者|從|他的僕人，|感恩|給兩個感謝:|與清除|忙，|與報告|用舌頭，|和兩個第一|傳達|從|兩個，第二個|敬畏神|他們|那些是誰|相信|在安拉|和一天|最後。|問題|內|幾個|案件|是|中午|標誌|後|主格|這個詞嗎?|用什麼|開始|動詞|現在時態|已連結|到|阿勒夫|第二個呢?|後|什麼|事|指示|字母|正在啟動|與它嗎?|用什麼|到職|動詞|現在時態|已連結|對 waw|或|是啊?|給|兩個例子|為每個|從|動詞|現在時態|已連結|到|阿勒夫|及至|waw|及至|是啊。|對象|ㄧㄣ|動詞|五個嗎?
GreatMasterpiece16=標誌|賓格的|它說:|和賓格|五|標誌|罰的罵，|和阿勒夫|和 kasra，|和呀，|和刪除|中午。|我說:|你能給|那|裁決|到|這個詞|與那它|發生|當|找到|於|它的結局|標誌|從|五|體征:|一|從它|來源語言|它是|罰的罵:|和四個|分支|從它，|和它是:|阿勒夫|和 kasra，|和呀，|和刪除|中午。
GreatMasterpiece17=罰的罵|和其案件|它說:|然後為|罰的罵|然後是|標誌|為賓格|於|三|例:|於|名詞|奇異，|和複數|壞了，|和動詞|現在時態|當|輸入|到它|虛擬語氣的情況下，|並沒有|已連結|與它的結局|所有的東西。|我說:|是|罰的罵|標誌|到|那|這個詞|是賓格|於|三|情況下，|案例|第一:|名詞|奇異，|與案例|第二:|複數|壞了，|與案例|第三:|動詞|現在時態|其中|它前面|虛擬語氣的情況下，|不具有|已連結|與它的結局|阿勒夫|第二，|而不是|waw|所述多個，|而不是|是啊|處理/第二人，|而不是|中午|重點，|而不是|中午|女性的特質。|對於|名詞|單數|然後當然|字樣/以前|其已知/定義，|和罰的罵|是|表觀|後|它的結局|於|就像|(我見過|阿裡)|就像|(我見過|後腿)|當年的阿裡，|和後腿:|兩個名詞|奇異，|和兩個|賓格;|當然那兩個|都是活躍的元素，|和標誌|兩個賓格|罰的罵|很明顯，|和第一次|男性|和第二個|女性，|和是|罰的罵|應該/暗示|就像:|(我見過|那個男孩)|和一樣:|(我報導|那個女孩)|然後那個男孩|和女孩:|兩個名詞|單數|是賓格;|因為|每個|從這兩個|事件|是有源元件|有了它，|和標誌|兩個賓格|是罰的罵|應該/暗示|後|阿勒夫|防止|其明顯|不是可能，|和第一次|男性|和第二個|女性。|和|複數|已中斷|然後當然|以前|其定義已知 /|此外，|和罰的罵|當然|是|表觀|後|它的結局，|就像|(我陪同|男人)|就像|(我照顧|印度人)|然後男人|和印地安人:|複數|已中斷|賓格|因為這兩個|都是活躍的元素，|和標誌|其賓格的|是罰的罵|很明顯，|和第一次|男性，|和第二個|女性，|和肯定|是|罰的罵|應該所隱含，|就像|它說:|最高:|(和你將看到|人類|在醉酒的 state)(22:2)|就像|它說:|最高:|(和嫁給|那些你們當中那些 single)(24:32)|然後在醉酒狀態|和那些你們中間是單身:|複數|已中斷|賓格;|因為這兩個|都是活躍的元素，|和標誌|其賓格的|是罰的罵|應該/暗示|後|阿勒夫|防止|從|其明顯|不可能的事。|和|動詞|現在時態|男性|然後就像|它說:|最高|(不會的|我們停止|在上面|worshiping)(20:91)|然後|(我們停止):|一個動詞|現在時態|虛擬案例|將不，|和標誌|其虛擬語氣案件|罰的罵|很明顯，|和肯定|是|罰的罵|應該所隱含，|就像|(這讓我高興|那|你努力|對|榮譽)|然後|(你努力):|一個動詞|現在時態|虛擬案例|這一點，|和標誌|其虛擬語氣案件|罰的罵|應該/暗示|後|阿勒夫|防止|從|其明顯|不可能的事。|然後如果|已連結|與結局|動詞|現在時態|阿勒夫|第二，|就像|(永遠不會|這兩個會命中/擊敗)|或|waw|所述多個，|就像|(永遠不會|你們都將命中/擊敗)|或|是啊|處理/第二人，|就像|(永遠不會|你女性將命中/擊敗)|非|是|其虛擬案例|與罰的罵，|然後每個|從|(兩會命中/擊敗)|RD|(你所有將命中/擊敗)|RD|(你女性將命中/擊敗)|都賓格|與永遠不會，|和標誌|其虛擬語氣案件|刪除|中午，|和阿勒夫|或|waw|或|是啊|活動元素|結構|後|sukoon|於|地方|指示的情況下，|你就會明白|解釋|，|在什麼|如下。|如果|已連結|與它的結局|中午|重點|重，|就像|(由真主|永不|可以肯定你會)|或|光線|(由真主|永不|可以肯定你會)|它是|結構|後|罰的罵|於|地方|虛擬案例。|如果|已連結|與它的結局|中午|女性的特質，|就像|(永遠不會|你所有女性將達到|榮譽|除了|與義)|它是|然後|結構|後|sukoon|於|地方|虛擬案例。|練習|1-|使用|單詞|追蹤|於|個句子|有意義|因此|是|賓格:|欄位，|花，|同學們，|球，|花園裡，|這條河，|這本書，|在兩座花園，|這支筆，|這匹馬，|這兩個男孩，|處女，|棍子，|為指導，|他喝，|他接受，|他希望，|你去旅行。|2-|付諸表決|於|地方|從|這個地方|自由/空|於|短語|給出了|名詞|發生|賓格|與罰的罵|很明顯，|並將其設置|表單:|(仲裁)|真正|......|同情|對|他們的兒子。|(B)|服從|......|因為他|你長大|和你的教育。|(C)|尊重|......|因為她|給你帶來。|(代理)|修訂​​|......|之前|那|呈現它。|(E)|執行|......|然後你真|通過這|服務|你的國家。|(F)|被|......|為確|怯懦|非|延長|生活。|(G)|總是有|......|為確|閒談|是之前故障的缺點。|(H)|保護|......|當從|發言|到|人。|() i|If|男子|......|他是|那些人|保持|他的職責。|(J)|誰|服從|......|進來|危險/危險的情況。|(K)|執行|......|即使|持續|其他比|他的人民。|(L)|較佳|......|會高興的|和你一起|真主。|問題|內|幾個|案件|是|罰的罵|標誌|後|賓格嗎?|車廠|為名詞|單數|賓格|四|例子:|其中之一|該名詞|單數|賓格|與罰的罵|很明顯，|和第二個|該名詞|單數|賓格|與罰的罵|應該所隱含，|和第三個|該名詞|單數|女性|賓格|與罰的罵|很明顯，|他們的第四|該名詞|單數|女性|賓格|與罰的罵|應該所隱含。|車廠|用複數形式|已中斷|賓格|四|範例|不同。|當|使虛擬語氣|動詞|現在時態|與罰的罵嗎?|車廠|為動詞|現在時態|虛擬語氣|兩個例子|不同。|用什麼|使虛擬語氣|動詞|現在時態|其中|已連結|與它|阿勒夫|第二個呢?|當|已連結|與結局|動詞|現在時態|前所未有|用虛擬語氣|中午|重點|那是什麼|是其執政嗎?|車廠|為動詞|現在時態|其中|已連結|與它的結局|中午|女性氣質|與它之間的自然數|虛擬語氣|含有|引用|作出的裁決。
GreatMasterpiece18=取代|阿勒夫|從|罰的罵|它說:|和|阿勒夫|然後是|標誌|為賓格|於|名詞|五、|就像:|(我見過|你的父親|和你的兄弟)|和什麼|類似|那。|我說:|當然|你知道的|在什麼|事先|名詞|五、|和條件|拐點|帶有 waw|是主格|和阿勒夫|是賓格|和嚴|是佔有，|和現在|我們通知你|與那|標誌|該值指示|後|那|一|其中|單詞|都賓格|目前狀態|alef 的|於|它的結局，|就像|(尊重|你的父親)|RD|(説明|你的哥哥)|RD|(訪問|你的岳父)|RD|(清潔|你的嘴)|RD|(不|尊重|私密金鑰的持有人|財富|因為他的財富)|然後每個|從|(你的父親，|和你的兄弟，|和你的公公，|和你的嘴|擁有|財富)|於|這些|範例|就像它|是賓格;|所以，它|發生|在它|效果|有了它，|和標誌|其賓格的|是 alef|更換|從|罰的罵，|和每個|從它|擁有，|和什麼|在它以後|從|kaaf，|RD|(財富)|擁有|到它，|和永遠不會|為 alef|案例|替代產品|在它|從|罰的罵|除了|此|案例。|問題|內|幾個|案件|替代產品|阿勒夫|從|罰的罵嗎?|給|為名詞|五|於|條件|賓格的|四|例子。
GreatMasterpiece19=取代|kasra|從|罰的罵|它說:|和|kasra|然後是|標誌|為賓格|於|複數|女性|聲音。|我說:|當然|你知道的|在什麼|事先|複數形式|女性氣質|聲音，|和現在|我們通知你|它|您可以|那|讓證據|後|賓格|此|複數形式|與存在|kasra|於|它的結局，|和那|就像|你說:|(實在|女孩子們|有禮貌|將達到|榮譽)|然後每個|從|(女孩)|RD|(彬彬有禮):|複數|女性氣質|聲音，|和兩個|是賓格;|因為是|第一; 首先|名詞|賓格助詞的實在，|而且因為是|第二|形容詞|賓格|和標誌|兩個賓格|kasra|更換|從|罰的罵。|永遠不會|為 kasra|案例|替代產品|在它|從|罰的罵|除了|此|案例。|演習/練習|1-|名次|奇異的女性|給出了|複數|女性|聲音|和他們是:|聰明的女人，|法蒂瑪，|蘇達|女老師，|彬彬有禮的女人，|浴室裡，|記憶與記憶。|2-|名次|每個|一|從|複數|女性|給出了|於|一個句子|有意義，|與條件|那|是|於|案例|賓格|和提供/套|與母音形式/分，|和他們是:|聰明的女性，|Fatimas，|印度教，|女教師，|uvulas，|浴室，|回憶和記憶。|3-|單詞|給出了|這是女性的|把/回復|每|一|從他們|到|奇異，|然後|地方|這些|單數|複數|女性氣質|聲音，|和使用|每|一|從他們|於|一個句子|有意義，|和他們是:|兩個贊，|懷孕了，這兩個|每個對兩個的作家，|兩條消息:|兩個女性紅色。
GreatMasterpiece20=取代|是啊|從|罰的罵|它說:|和|是啊|然後是|標誌|為賓格|於|雙|和複數形式。|我說:|當然|你就會知道|雙|在什麼|過去，|和像那樣|當然|你就會知道|複數|男性|聲音|和現在|我們會通知你|它|您可以|那|眾所周知，|賓格|一個|從這兩個|與存在|yah 型|於|它的結局，|與差異|兩者之間|那|是啊|於|雙|是|什麼|在它之前|有罰的罵|和什麼|在它以後|有 kasra，|和嚴|於|複數|男子氣概|是|什麼|在它之前|有 kasra|和什麼|在它以後|有罰的罵。|然後示例|雙|(我看著|兩個麻雀，|如上|樹上)|就像|(買了|我的父親|兩本書|其中之一|對我來說|和其他|為我的弟弟)|然後每個|從|(兩個麻雀)|RD|(兩本書)|是賓格|因為|效果|有了它，|標誌|其賓格的|是啊|有罰的罵|什麼|在它之前是|有 kasra|什麼|是在它以後，|因其|是雙重的|到中午|偏移量/地點|從|noonation|於|名詞|奇異。|和一個例子|複數形式|男子氣概|聲音|(真正|上帝意識|將實現|快樂|他們的主) 的|和一樣:|(我建議|勤勞的工人|專門從事|後|學習/學習)|然後每個|從|(上帝意識)|RD|(硬工人)|賓格;|因為它|效果|有了它，|和標誌|其賓格的|是呀|有 kasra|什麼|在它之前是|有罰的罵|什麼|是後它;|為此，它是|複數|男子氣概|聲音，|到中午|偏移量/放|從|noonation|於|中午|奇異。|演習/練習|1-|單詞|給出了|是單數形式|他們然後雙|他們，每個人都|然後地方|從他們|什麼|可以將聲音|那|多元化|複數|男性|聲音，|和他們是:|默罕默德，|法蒂瑪，|· 貝克爾|食肉獸，|這位作家，|老虎，|法官，|選擇的之一。|2-|使用|每個|雙|從|雙形式|給出了|於|一個句子|有用|與那時|是|賓格|並提供它|加母音符號|充分，|和他們是:|兩個穆罕默德，|兩個 Fatimas，|兩個 Bakrs，|兩只老虎，|兩位作家，|兩只老虎，|兩名法官，|兩人揀選的人。|3-|使用|每個|一|從|複數|給出了|於|一個句子|有意義|與那時|是|賓格|並提供它|加母音符號|充分，|和他們是:|正確地引導的|伊斯蘭法的穆夫提/官方解釋者|聰明的那些，|作家，|選擇/選擇/最喜歡的。
GreatMasterpiece21=取代|刪除|中午的|從|罰的罵|它說:|和|刪除|中午的|然後是|標誌|為賓格|於|動詞|五|其中|它主格|與恒常性|中午。|我說:|當然|你知道的|用什麼|是事先|什麼|ㄧㄣ|動詞|五、|和現在|我們通知你|它|您可以|那|你知道的|賓格|每|一|從他們|當|你找到|中午|其中|是|標誌|主格的|刪除，|和他們的例子|於|條件|賓格的|你說:|(這讓我高興|那|你記住|你的課程)，|和一樣:|(它傷害了我|從|那些懶惰的人|那|忽視|於|他們的職責)，|然後每個|從|(你背誦)|RD|(他們忽略了)|是動詞|現在時態|賓格|與微粒，|和標誌|其賓格的|刪除|中午，|waw|所述多個|活動元素|結構|後|sukoon|於|地方|主格。|像那樣|已連結|alef|第二，|就像|(這讓我高興|那|兩個你取得的成就|每個夢想兩的欲望)|和附加|與閻|解決，|就像:|(它傷害了我|那|你女性忽視|於|你的責任)，|和肯定|你知道的|如何|你活用它們。|演習/練習|1-|使用|單詞|給出了|主格|有一次，|和賓格|預付方案|其他，|於|一個句子|有意義，|和放|與母音符號:|這本書，|紙，|然後筆，|墨水瓶，|老虎，|這條河，|大象，|花園裡，|駱駝，|花園，|利潤，|良好的舉止，|他變得可見/清楚，|真實的婦女，|貞潔的婦女，|母親，|兄弟們，|女教師，|老師們，|列祖，|你的兄弟，|標誌，|男子氣概，|這兩個朋友，|你的父親，|朋友們，|信徒，|農民|敬畏上帝，|你們兩個站起來，|這兩個正在玩。|問題|當|是|kasra|標誌|為賓格嗎?|當|是|是啊|標誌|為賓格嗎?|內|幾個|案件|是|刪除|中午的|標誌|為賓格嗎?|車廠|為複數形式|女性氣質|賓格|兩個例子|和活用|一|從兩個，|讓|動詞|五|虛擬語氣|三|範例|和活用|一|從他們，|讓|為複數|男子氣概|聲音|賓格|用兩個例子，|讓|為複數|男子氣概|聲音|主格|用兩個例子，|讓|雙表單|賓格|用兩個例子，|讓|雙表單|主格|用兩個例子，|讓|動詞|五|陳述語氣|兩個例子。
GreatMasterpiece22=標誌|所有格的|它說:|和所有格|三|體征:|kasra，|和呀，|和罰的罵。|我說:|您可以|那|你知道的|這個詞|所有格的|當|你找到|在他們|一|從|三|事情:|第一; 首先|是 kasra，|它是|原始源|於|所有格，|和第二個|是呀，|第三個|是罰的罵，|和兩個|分支|從|kasra|和每個|一|從|這些|事情|三|案例|是|在它，|我們將解釋|給你的|其例|詳細說明|在什麼|如下。
GreatMasterpiece23=取代|是啊|從|kasra|它說:|和|是啊|然後是|標誌|為所有格|於|三|例:|於|名詞|五、|中和|二元性|和複數形式。|我說:|對呀|三|案件|被|於|每|一|從他們|該值指示|後|那|名詞|是所有格。|案例|第一:|名詞|五、|和肯定|你知道他們，|和你知道|條件|他們的拐點的|用什麼|事先，|和那|就像:|(迎接和平 /|後|你的父親|在上午|日|一天)|就像|(不|提高|你的聲音|後|聲音|你的弟弟|大)|就像|(不|執行|愛|為私密金鑰的持有人|財富|除了|那|是|有禮貌)|然後每個|從|(你的父親，|和你的兄弟，|擁有|財富)|所有格;|用於輸入|這封信|所有格的|在其上，|和標誌|其所有格的|是呀，|和 kaaf|於|前兩個|代詞|處理/第二人，|它是|擁有|到它|結構|後|罰的罵|於|地方|所有格，|和字|(的財富)|於|該示例|第三個|擁有|到它|此外，|所有格|與 kasra|明顯。|案例|第二:|二元性，|和那|就像|(看看|於|兩名士兵)，|就像|(迎接和平 /|後|這兩個朋友)|然後每個|從|(兩名士兵，|和兩個朋友)|所有格;|用於輸入|這封信|所有格的|在其上，|和標誌|其所有格的|是呀|有罰的罵|什麼|在它之前|有 kasra|什麼|在它之後，|和每個|從|(兩名士兵，|和兩個朋友)|雙;|為此他們|表示|後|第二個。|案例|第三:|複數|男子氣概|聲音，|就像|(我很高興|含有|Bakrs)，|就像|(我看|於|穆斯林|謙卑)|然後每個|從|(Bakrs，|和穆斯林)|所有格;|用於輸入|這封信|所有格的|在他們身上，|和標誌|其所有格的|是呀|有 kasra|什麼|在它之前|有罰的罵|什麼|在它之後，|和每個|從他們|複數|男子氣概|聲音。|演習/練習|1-|付諸表決|每個|動詞|從|動詞|給出了|於|兩個句子|被|主格|於|其中之一，|和賓格|於|其他。|他跑，|他建立了，|他打掃，|他騎|他擦去，|他喝，|他點燃。|2-|付諸表決|每個|名詞|從|名詞|給出了|於|三|句子，|與那時|被|主格|於|其中之一|和賓格|於|第二|和所有格|於|第三，|和集/調整|含有|母音的跡象:|你的父親，|你的兄弟，|你的牙齒，|這本書，|火車上，|水果，|母親，|朋友們，|兩名學生，|兩個男人，|那個士兵，|那個女孩，|你的兄弟，|你的朋友|兩名士兵，|這兩個男孩，|商人，|玫瑰，|尼羅河|浴/清洗，|活潑，|粗心，|有禮貌。|問題|對象|現在|案件|其中|被|是啊|在他們|標誌|後|所有格|名詞嗎?|對象|區別是|介於|雙|和複數|男子氣概|於|條件|所有格嗎?|車廠|雙表單|所有格的|三|例子嗎?|車廠|為複數形式|男子氣概|所有格|三|範例|也。|車廠|為名詞|五|三|範例|被|名詞|於|每個|一|從他們|所有格。
GreatMasterpiece24=取代|罰的罵|從|kasra|它說:|和|罰的罵|然後是|標誌|為所有格|於|名詞|其中|非|完全屈折變化。|我說:|為罰的罵|案例|一|是|標誌|後|所有格|名詞的|它是|名詞|其中|非|完全屈折變化。|和意義|是它|非|完全屈折變化:|它|非|之前接受|每個對完整的拐點，|它是|noonation，|和名詞|其中|非|完全屈折變化|它是:|(這其中|類似于|動詞|於|存在|兩個原因|中學/分組:|其中之一|傳回|到|表達，|和其他|傳回|到|意思，|或|目前狀態|在它|原因|一|常設/帶|這個地方|兩個的原因)。
GreatMasterpiece25=和原因|其中|是發現|於|名詞|該值指示|後|子群|和他們是|返回|到|意義|第二個|不是|其他比:|第一; 首先|正確，|第二|描述性，|它必須|從|目前狀態|之一|從|這兩個|原因|於|名詞|防止|從|充分的拐點|有理由|存在|兩個原因|在它。|和原因|其中|是發現|於|名詞|並指示|後|分組|和是|返回|到|運算式|於|六|情況下，|和他們是:|女性|與其他比|alef，|和非阿拉伯文|與複合施工|和另外|alef 的|到中午，|和規模|動詞，|和異常，|和它必須|從|目前狀態|之一|從|這些|原因|含有|目前狀態|適當人選|在它，|和|含有|描述性|然後不|找到|從它|除了|一|從|三、|和他們是:|新增|alef 的|到中午，|或|規模|動詞，|或|異常。|然後示例|正確的|含有|女性|與其他比|阿勒夫:|法蒂瑪，|和贊，|和哈姆紮。|和實例|正確的|含有|非阿拉伯文:|伊德里斯|雅各的神，|和亞伯拉罕。|和實例|正確的|含有|複合的建設:|阿拉伯的人，|和黎巴嫩的城市，|和著名的科學家統治者判斷，|和聰明的波斯文，|和伊朗的城市。|和實例|正確的|含有|新增|alef 的|到中午:|瑪律萬，|和奧斯曼，|和 Gatfaan/部落主義，|和阿凡，|和 · 薩赫班，|和揚，|和伊姆蘭，|和 Qahtan，|和 Adnan。|和實例|正確的|含有|規模|動詞:|Ahmad/表揚，|和 Yashkur/謝謝你，|和 Yazeed/增加，|Taglib/克服，|和莫爾/銷毀。|和實例|正確的|含有|異常:|歐麥爾|和 Zufar/教法的科學家，|和 Qutham，|和偶像，|與土星，|和部落主義，|和彩虹，|和流氓。|和實例|描述性|含有|新增|alef 的|到中午:|精心澆灌，|和全/滿意，|和醒來周到。|和實例|描述性|含有|規模|動詞:|越高貴，|更好，|而更美麗。|和實例|描述性|含有|異常:|三三兩兩 / 雙，|和第三 / 三五成群，|和第四次 / 四腳著地，|和其他人。|和|兩個原因|其中|矮櫃|每個|一|從這兩個|這個地方|兩個原因|然後這兩個是:|公式/模式|結局的|複數，|阿勒夫|女性|有限|或|擴展。|對於|公式/模式|結局的|複數|然後是它的一般規則:|那|是|名詞|複數形式|壞了，|和肯定|發生|之後|阿勒夫|其破碎|兩封信|就像:|清真寺，|和講壇/酒水，|更好，|更尊貴，|和更接近于完美/更多類似/像，|和不舒服/來月經，|和不舒服/來月經，|或|三|個字母|它的中間|母音-少，|就像:|一把鑰匙|和麻雀，|和蠟燭/燈。|和|阿勒夫|女性|有限|然後就像:|懷孕了，|和大多數，|和世界，|和索賠。|和|阿勒夫|女性|擴展|然後就像:|紅色，|和黑色的大眼睛的女性，|和美麗，|和白色的|和黑色的眼睛，|和隧道，|和科學家。|然後每個|什麼|我們已經提到過|從|這些|名詞，|和喜歡|什麼|看起來好像，|非|允許|其 tanween|和使所有格|與罰的罵|更換|從|kasra，|就像:|(稱呼|真主|安寧|亞伯拉罕 ·|他的朋友)|和一樣:|(可能是高興|真主|含有|歐麥爾|前置字元|信徒):|然後每個|從|亞伯拉罕 ·|和歐麥爾:|所有格;|用於輸入|信件|所有格的|在其上，|和標誌|他們兩個的所有格的|罰的罵|更換|從|kasra|為此|每個|一|從這兩個|一個名詞|非|完全屈折，|和預防|從|充分的拐點|亞伯拉罕的|是正確的|非阿拉伯文|和預防|從|充分的拐點|歐麥:|正確|與異常。|等|後|那|剩下的人。|和所需|為所有格|名詞|其中|非|完全屈折變化|與罰的罵:|那|是|空閒|從|(粒子)|而不是|已連結|到|名詞|在它之後，|然後如果|再加上|與的粒子|或|已加入|所有格|與 kasra，|就像|它說:|最高|(和你|專門討論|於|清真寺|)(2:187)|和一樣:|(我通過|由美麗的女人|商隊的)。|演習/練習|1-|請參閱|原因|其中|是新任|防止|充分的拐點|於|每個|word|從|單詞|給出:|贊，|流氓，|約瑟夫，|亞伯拉罕，|更尊貴|於|Ahmad，|黎巴嫩的城市，|充滿了水，|掛鎖，|Hassan，|阿舒拉節，|世界。|2-|付諸表決|每個|word|從|單詞|給出了|於|兩句話，|與那時|是|於|兩個之一|所有格|與罰的罵|更換|從|kasra，|中和|第二|所有格|與 kasra|明顯。|黑色的大眼睛的女性，|接近完美/更多類似的/象，|比，更美麗|保持警惕。|3-|付諸表決|於|這個地方|自由/空|從|這句話|給出了|一個名詞|防止|從|充分的拐點|並將其設置|與母音的跡象，|然後|請參閱|原因|於|其預防:|(仲裁)|遊記|......|含有|你的哥哥。|(B)|......|是更好|於|......|(C)|有了|含有|......|訪客|從|......|(代理)|這座清真寺|Amr/領袖的|是老|什麼|在埃及|於|......|(E)|這|女孩|......|(F)|......|出現|之後|雨中。|(G)|我通過|由一個饑餓的窮人|......|所以我給了捐贈慈善機構 /|給他。|(H)|給予施捨/善良|到|有害/施虐者|......|為到|安全的救。|() i|......|我們有同情/感情用事|為後|窮人。|問題|對象|現在|案件|其中|被|罰的罵|在他們|標誌|/|所有格|名詞嗎?|和什麼|意思是|是|名詞|非|完全屈折變化嗎?|對象|ㄧㄣ|名詞|其中|非|反映嗎?|對象|ㄧㄣ|原因|其中|傳回|到|的意思嗎?|對象|ㄧㄣ|原因|其中|傳回|到|表達嗎?|幾個|原因|從|原因|運算式|被發現|含有|軟糖嗎?|幾個|原因|從|原因|運算式|被發現|含有|國際音標嗎?|對象|是兩個|原因|其中|站/加注|一|從這兩個|一個地方|兩個原因嗎?|車廠|為一個名詞|非|完全屈折變化|是否存在|正確的|與異常，|和描述性|與異常，|和適當的|和另外|alef 的|到中午，|和描述性|和另外|alef 的|到中午，|和適當的|和女性，|和描述性|和規模|動詞，|和適當的|和非阿拉伯文。
GreatMasterpiece26=標誌|命令的心情|它說:|和其命令的理由|兩個標誌:|蘇坤|和刪除。|我說:|它是可能|那|作出裁決|後|這個詞|與那|是命令案例|當|找到|在它|一|從|兩件事;|第一:|蘇坤|它是|標誌|原始|為命令的情況下，|和第二個:|刪除，|它是|標誌|中學，|和每個|一|從|這兩個|標誌|是的地方|我們會提醒他們|給你的|在什麼|如下所示:
GreatMasterpiece27=這個地方|蘇坤的|它說:|然後為|蘇坤|然後它是|標誌|命令的理由|於|動詞|存在|聲音|結束。|我說:|為蘇坤|第一; 首先|地方|ㄧㄣ|在它|標誌|後|那|word|命令的心情，|與此|地方|它是|動詞|存在|聲音|結局，|和意義|正在|聲音|結束|那|它的結局|不是|其信|從|個字母|缺陷|三|其中|現在|阿勒夫|和 waw|和嚴。|和實例|動詞的|存在|聲音|結束|(他戲劇|和他成功|和他的旅行|和他的承諾|和他問)|然後當|你說:|(沒有|播放|阿裡)|RD|(沒有|成功/通|愚蠢的人)|RD|(沒有|傳導|你的哥哥)|RD|(沒有|承諾|亞伯拉罕 ·|對哈立德|與任何東西)|RD|(沒有|問|巴克爾|給老師)|然後每個|從|這些|動詞|是命令的情況下，|前|粒子|命令的情況下|其中|ㄧㄣ|(沒有)|在其上，|和標誌|其命令的案件|是蘇坤|和每個|一|從|這些|動詞|是一個動詞|存在|聲音|結局。
GreatMasterpiece28=地方|刪除的|它說:|和|刪除|它是|標誌|為命令|於|動詞|存在|弱|結局|中和|動詞|五|其中|它指示|切除|中午。|我說:|刪除|兩個地方|現在|於|每個|一|從兩|標誌|和一個標誌|後|命令|這個詞。|這個地方|第一:|動詞|存在|弱|結局，|和意義|正在|弱|結局|那|它的結局|信件|從|個字母|有缺陷|三|其中|現在|阿勒夫|和 waw|和嚴。|然後該示例|動詞的|存在|其中|它的結局|是 alef|(他奮鬥，|和他接受，|和他愛/而變得喜歡，|和他很遠，|而且他仍然)|和示例|動詞的|存在|其中|它的結局|是 waw|(他的電話/supplicates，|他希望，|和他的測試中，|他是高|和他是殘酷的|和他是遠了)|和示例|動詞的|存在|其中|它的結局|是呀|(他給，|和他的法官，|他的封面，|他賜生命，|和他輪流/曲線，|和他指導)|然後當|你說:|(沒有|奮鬥|阿裡|走向|榮譽)|然後如果|(他求)|命令的心情;|為前|粒子|命令|在其上，|和標誌|其命令的|刪除|alef 的|和罰的罵|在它之前|標誌|在其上，|它是|動詞|存在|弱|結局，|和什麼時候|你說:|(沒有|通話|默罕默德|除了|到|真相)|然後如果|(電話)|動詞|存在|命令的心情;|因為之前|粒子|命令|在其上，|和標誌|其命令的|刪除|waw 的|和 damma|在它之前|該值指示|在其上，|和什麼時候|你說:|(沒有|讓|默罕默德|除了|對哈立德)|然後如果|(給)|一個動詞|存在|命令的心情|因為之前|粒子|命令|在其上，|和標誌|其命令的|刪除|呀，|和 kasra|在它之前|該值指示|在其上，|尋求|後|那|及其同夥。|這個地方|第三:|動詞|五|其中|僅供參考|與證明|中午，|和肯定|之前|與它的聲明，|和它的例子|(兩個男性節拍，|和兩個女性 / 你兩個的男性/女性節拍，|他們男性打，|和你所有男性打，|和你女性打敗)|和你說|(沒有|兩個男性節拍，|也沒有|兩個女性 / 你兩個的男性/女性節拍，|也沒有|他們陽剛擊敗，|也沒有|你所有男性打，|也沒有|女性的打)|為每個|一|從|這些|動詞|是一個動詞|存在|命令的心情;|因為之前|粒子|命令|其中|它是|(沒有)|在其上，|和標誌|其命令的|是刪除|中午，|和阿勒夫|或|waw|或|葉|活動元素的|結構|後|蘇坤|於|地方|指示性。|演習|1-|使用|每個|動詞|從|動詞|給出了|於|三|個句子|有意義，|所以|ㄧㄣ|於|每個|一|從他們|陳述語氣，|中和|第二|虛擬語氣|中和|第三|命令的心情，|和放|與詞根|完成|於|每個|句子:|他打了，|你們兩個幫忙，|你女性的旅行，|他就在附近，|所有男性你贏了，|他買了，|他依然，|他們兩個在前面。|2-|付諸表決|於|地方|空閒|從|這句話|給出了|動詞|存在|虛擬語氣，|然後|參照|標誌|它的拐點:|(仲裁)|懶惰的人|......|到|他自己|和他的祖國。|(B)|從未|......|榮譽|除了|艱苦的工作|和毅力。|(C)|朋友|真誠|......|為幸福|他的朋友。|(代理)|兩個女孩|勤勞的工人|......|他們的父親。|(E)|學生|光榮|......|他們的國家。|(F)|您|哦我的朋友|......|與您的光臨。|(G)|來自|事蹟|好|真的是他|......|(H)|If|傷害你人|部分|你的兄弟的|然後不|......|() i|我很高興|那|......|你的兄弟。|(J)|If|你做你|工作|......|(K)|沒有|......|我的父親|昨天。|(L)|您|哦贊|......|你的責任。|(M)|If|你來看我|......|(N)|無論|您已隱藏|......|問題|對象|現在|標誌|命令嗎?|內|幾個|地點|ㄧㄣ|蘇坤|標誌|為命令嗎?|內|幾個|地點|ㄧㄣ|刪除|標誌|後|命令嗎?|對象|ㄧㄣ|動詞|聲音|結局嗎?|車廠|為動詞|聲音|結局|十|例子，|什麼|ㄧㄣ|動詞|有缺陷|結局嗎?|車廠|為動詞|有缺陷|其中|它的結局|alef 的|與五|例子，|和像那樣|動詞|其中|它的結局|waw 的|成為|為動詞|其中|它的結局|yah 型|用兩個例子，|什麼|現在|動詞|五個嗎?|用什麼|使命令|動詞|五個嗎?|車廠|動詞|五|命令的情況下|與五|例子。
GreatMasterpiece29=屈折變化|它說:|(司)|屈折變化|分為兩個部分:|部分|屈折變化|與母音的跡象，|和部分|屈折變化|用字母。|我說:|想要|作者|-|可能是他滿意|真主|最高|-|有了這些|部門|那|是指|後|總結的方式|其中，|這項裁決|什麼|以前|它闡述了|於|地方|拐點，|地位和身份|其中|以前|提到了|他們的裁決|於|拐點|擬訂|八、|和他們是:|名詞|奇異，|和複數|破碎的|和複數|女性|聲音，|和動詞|現在時態|其中|非|已連結|與它的結局|任何事情，|和雙，|和複數|陽剛氣|聲音，|和名詞|五、|和動詞|五、|和這些|種類|-|其中|現在|地點|拐點|-|劃分|into|兩個部分:|第部分|第一個|屈折變化|與母音的跡象，|第部分|第二個|屈折變化|用字母，|和如下|一種解釋|每個|組件|從這些|闡述了。
GreatMasterpiece30=屈折變化|與母音跡象|它說:|然後，|屈折變化|與母音跡象|四|事情:|名詞|奇異，|和複數|破碎的|和複數|女性|聲音，|和動詞|現在時態|其中|非|連接的|與它的結局|所有的東西。|我說:|母音跡象|有三個，|和他們是:|damma，|和罰的罵，|和 kasra，|並將追加|與他們|蘇坤|和肯定|你知道的|那|屈折變化|都注視著|兩個部分:|部分|屈折變化|與母音的跡象，|和部分|屈折變化|用字母|和那|開始|於|解釋|第部分|第一個|其中|反映|與母音的跡象，|它是|四|事情:|1-|名詞|奇異，|和它的例子|(穆罕默德)|RD|(課)|從|你說:|(還記得|默罕默德|這一課)|然後記得:|一個動詞|過去式|結構|後|罰的罵|非|一個地方|為它|從|屈折變化，|和默罕默德:|使用中的元素|主格，|和標誌|它主格的|是 damma|很明顯，|和經驗教訓:|物件|與它|是賓格|和標誌|其賓格的|是罰的罵|很明顯，|和每個|從|(穆罕默德)|RD|(課)|是一個名詞|奇異。|2-|複數形式|破碎的|和它的例子|(學生)|RD|(教訓)|從|你說:|(記得|學生|經驗教訓)|然後記得:|一個動詞|過去式|結構|後|罰的罵|非|一個地方|為它|從|屈折變化，|學生:|活動元素|主格|和標誌|它主格的|damma|很明顯，|經驗教訓:|動|在上面|賓格|和標誌|其賓格的|罰的罵|很明顯，|和每個|從|(學生，|和經驗教訓)|複數|破碎) 的|3-|複數形式|女性氣質|聲音，|和它的例子|(相信婦女)|RD|(祈禱)|從|你說:|(擔心|相信婦女|於|祈禱)|當時擔心:|一個動詞|過去式|結構|後|罰的罵|非|一個地方|為它|從|屈折變化，|相信婦女:|活動元素|主格|和標誌|它主格的|damma|很明顯，|中和|粒子|所有格，|祈禱:|所有格|同在|和標誌|其所有格的|kasra|很明顯，|和每個|從|(相信婦女，|並為他們祈禱)|複數形式|女性氣質|聲音。|4-|動詞|存在|其中|非|已連結|與它的結局|任何事情，|和它的例子|(他走)|從|你說:|(到了。|默罕默德)|然後他去:|一個動詞|存在|陳述語氣|為其免費|從|虛擬語氣|與命令，|和標誌|它指示性的|damma|很明顯，|和默罕默德|活動元素|主格|和標誌|它指示性的|damma|明顯。
GreatMasterpiece31=起源|/|拐點|這其中|是屈折|與母音的跡象，|和什麼|被排除在外|從他們|它說:|和他們每個人都|由主格|與 damma，|和做賓格|與罰的罵，|和做的所有格|與 kasra，|和作出的命令|與蘇坤，|和失散|從|那|三|事情:|複數形式|女性氣質|聲音|作賓格|與 kasra，|和名詞|其中|非|充分 inflectable|是由所有格|與罰的罵，|和動詞|存在|已連結|它的結局|命令|與刪除|它的結局。|我說:|起源|於|事情|四|其中|活用|與母音符號:|那|反映|與 damma|和做賓格|罰的罵，|和做的所有格|與 kasra，|和作出的命令|與蘇坤。|然後為|主格|與 damma|然後真正|他們每個人都|當然|來了|後|什麼|ㄧㄣ|起源|在他們，|然後主格|其複數形式的|與 damma，|和它的例子:|(遊記|默罕默德|和朋友|並相信婦女)|然後旅行:|一個動詞|存在|陳述語氣|為其免費|從|虛擬語氣|與命令，|和標誌|它主格的|damma|很明顯，|它是|一個名詞|奇異，|和朋友們:|主格|因其|合取|後|主格，|和標誌|它主格的|是 damma|很明顯，|它是|複數|破碎的|並相信婦女:|主格;|因其|還|合取|後|主格，|和標誌|它主格的|damma|很明顯，|它是|複數|女性氣質|聲音。|和|賓格|與罰的罵|然後當然|他們每個人都|來了|後|什麼|ㄧㄣ|起源|在它，|什麼|除了|複數形式|女性氣質|聲音，|然後當然它|讓賓格|與 kasra|更換|從|罰的罵，|它的例子:|(不會的|反對|默罕默德|和朋友們|並相信婦女)|然後反對:|一個動詞|存在|虛擬語氣|將不，|和標誌|其虛擬語氣的|罰的罵|很明顯，|和默罕默德|動|與它|賓格|和標誌|其賓格的|罰的罵|表觀|此外，|它是|一個名詞|單數|就像|它表明，|和朋友們:|賓格|因其|合取|後|賓格|和標誌|其賓格的|罰的罵|表觀|此外，|它是|複數|破碎的|就像|它表明，|相信婦女|賓格|因其|是合取|後|賓格|此外，|和標誌|其賓格的|kasra|更換|持續|罰的罵，|因其|複數|女性氣質|聲音。|和|所有格|與 kasra|然後確實|他們的每個|當然|來了|後|什麼|ㄧㄣ|起源|在它，|那|除了|動詞|現在時態|然後當然它|非|使得所有格|起源，|和那|除了|名詞|其中|非|充分反映，|然後當然它|反映|與罰的罵|更換|從|kasra，|和它的例子:|(我通過|由穆罕默德，|和男人，|相信婦女，|和 Ahmad)|然後我通過:|動詞|和積極的元素，|和呸|一個粒子|所有格，|和默罕默德:|所有格|與呸，|和標誌|其所有格的|kasra|很明顯，|它是|一個名詞|單數|完全屈折變化|就像|你明白，|和男人:|所有格，|因其|是合取|後|所有格，|和標誌|其所有格的|kasra|很明顯，|它是|複數|破碎的|充分 inflectable|就像|你理解|此外，|並相信婦女:|所有格，|因其|合取|後|所有格|此外，|和標誌|其所有格的|kasra|很明顯，|它是|複數|女性氣質|聲音|就像|你理解|此外，|和 Ahmad:|所有格，|因其|是合取|後|所有格|此外，|和標誌|其所有格的|罰的罵|更換|從|kasra，|因其|是一個名詞|非|充分 inflectable，|和預防|為它|從|拐點|專有名詞|和規模|動詞。|和|命令|與蘇坤|然後你|知道|那|命令|指定的|與動詞|目前，|然後如果|被|聲音|結局|然後如果|其命令|與蘇坤|就像|它是|起源|於|命令，|和它的例子:|(沒有|傳導|哈立德)|然後沒有:|一個粒子|否定之否定|和的命令|和的複分解反應/更改，|和旅行:|一個動詞|現在時態|命令的心情|與沒有，|和標誌|其命令的|蘇坤|和哈立德:|使用中的元素|主格，|和標誌|它主格的|damma|很明顯，|如果|是|動詞|現在時態|已連結|它的結局|是|其命令|與刪除|這封信的|有缺陷，|和它的例子:|(沒有|奮鬥|· 貝克爾|也沒有|他呼叫/邀請，|也沒有|執行|這是|他)|然後每個|從|(努力，|和電話/邀請，|和執行)|一個動詞|現在時態|命令的心情|與沒有，|和標誌|其命令的|刪除|alef 的|從|(努力)|和罰的罵|在它之前|標誌|在其上，|和刪除|waw 的|從|(調用/邀請)|和 damma|在它之前|標誌|在其上，|和刪除|yah 型|從|(執行)|和 kasra|在它之前|標誌|在上面。
GreatMasterpiece32=屈折變化|用字母|它說:|而|反映|用字母|四|類型:|雙，|和複數|男子氣概|聲音，|和名詞|五、|和動詞|五、|和他們是:|他們兩個男性做，|和他們兩個女性你們兩個做|他們所有男性這樣做，|所有男性的你，|和女性的你。|我說:|第部分|第二個|從|屈折變化:|事情|其中|活用|用字母，|字母|其中|被|標誌|後|詞形變化|四、|和他們是:|阿勒夫|和 waw|和呀，|到中午，|和那的|反映|有了這些|個字母|四|事情:|1-|二元性，|和預期|與它|雙，|和它的例子:|(兩個國家，|和兩個穆罕默德，|和兩個 Bakrs，|和兩個男人)|2-|複數形式|男子氣概|聲音，|和它的例子:|(穆斯林，|Bakrs，|穆罕默德)|3-|名詞|五|和他們是:|(你的父親，|和你的兄弟，|和你的岳父大人，|和你的嘴，|和擁有|財富)。|4-|動詞|五|和他們的例子:|(兩名男子襲擊，|和這兩個女人 / 你兩個寫/訂明，|和他們所有的人明白，|和你所有的人保留/背誦，|你女性是花不眠/晚上/喚醒)。|會給你|示威活動|拐點|每個|一|從|這些|事情|四|在詳細資訊。
GreatMasterpiece33=拐點|雙|它說:|然後為|二元性|然後你讓主格|alef|你讓賓格|和使所有格|與嚴。|我說:|第一; 首先|從|事情|其中|活用|用字母|(二元)|和它是:|雙|就像|你知道的|和肯定|你理解|在什麼|上一步|你明白|雙。|和其裁決:|那|你使主格|alef|更換|從|damma，|和使賓格|和使所有格|與閻|有罰的罵|什麼|在它之前是|有 kasra|什麼|在它之後是|更換|從|罰的罵|或|kasra，|並繼續|與它|之後|阿勒夫|或|是啊|中午|ㄧㄣ|替代|從|noonation|其中|ㄧㄣ|於|名詞|奇異，|而不是|被刪除|此|中午|除了|從|擁有在所有格的建設。|然後示例|雙|主格|(出席|兩名法官，|說:|兩個男人)|然後每個|從|(兩名法官)，|RD|(兩人)|主格|因其|是活躍的元素，|和標誌|它主格的|阿勒夫|更換|從|damma，|因其|是雙重的|中午|替代產品|從|noonation|於|名詞|奇異。|和一個例子|雙的|賓格|(我愛|這兩個彬彬有禮，|我不喜歡|兩個懶/懶惰的人)|然後每個|從|(彬彬有禮的兩個)|RD|(兩個懶惰/懶惰)|賓格|因其|動|在其上，|和標誌|其賓格的|是呀|與罰的罵|什麼|在它之前是|與 kasra|什麼|在它之後是|更換|從|罰的罵，|因其|是雙重的|到中午|替代|從|noonation|於|名詞|奇異。|和一個例子|雙|所有格|(我看|於|兩個騎兵|在|兩匹馬)|然後每個|從|(兩個騎兵)|RD|(那兩匹馬)|所有格，|用於輸入|顆粒|所有格的|到它，|和標誌|其所有格的|是啊|與罰的罵|什麼|在它之前是|與 kasra|什麼|在它之後是|更換|從|kasra，|因其|是雙重的|到中午|替代|從|noonation|於|名詞|奇異。
GreatMasterpiece34=拐點|複數形式|男子氣概|聲音|它說:|和|複數|男子氣概|聲音|然後它使主格|帶有 waw|和使賓格|和使所有格|與嚴。|我說:|第二|從|事情|其中|活用|用字母|(複數形式|男子氣概|聲音)|和肯定|你知道的|在什麼|上一步|意思|複數|男子氣概|聲音。|和其裁決:|那|使得主格|帶有 waw|更換|從|damma|和使賓格|和使所有格|與閻|與 kasra|什麼|在它之前是|與罰的罵|什麼|在它之後是|更換|從|罰的罵|或|kasra，|它會繼續|與它|之後|waw|或|是啊|中午|ㄧㄣ|替代|從|noonation|於|名詞|奇異，|和刪除|這|中午|含有|在擁有建設擁有|像中午|雙。|然後示例|複數形式|男性|聲音|主格|(出席|穆斯林)|RD|(成功|指揮官|這是好的)|然後每個|從|(穆斯林)|RD|(指揮官)|主格|因其|使用中的元素|和標誌|它主格的|waw|更換|從|damma|因其|複數|男子氣概|聲音，|到中午|是一個替代品|從|noonation|於|名詞|奇異。|和一個例子|複數形式|男子氣概|聲音|賓格|(我見過|穆斯林)|RD|(我尊重|指揮官|這是好的)|然後每個|從|(穆斯林)|RD|(指揮官)|賓格;|因其|動|在其上，|和標誌|其賓格的|是啊|與 kasra|什麼|在它之前是|與罰的罵|什麼|是後它;|因其|是複數|男子氣概|聲音，|到中午|替代|從|noonation|於|名詞|奇異。|和一個例子|複數形式|男子氣概|聲音|所有格|(與我一同參加|與指揮官|這是好的)|RD|(可能是高興|真主|含有|信徒)|然後每個|從|(指揮官)|RD|(信徒)|所有格，|用於輸入|粒子|所有格的|對此，|和標誌|其所有格的|是啊|與 kasra|什麼|在它之前是|與罰的罵|什麼|是在它以後，|因其|複數|男子氣概|聲音，|到中午|替代|從|noonation|於|名詞|奇異。
GreatMasterpiece35=拐點|名詞的|五|它說:|和|名詞|五|然後它使主格|帶有 waw，|和使賓格|alef，|和使所有格|與嚴。|我說:|第三|從|事情|其中|活用|用字母|(名詞|五)|和肯定|上一步|它指出|並引用|條件|其拐點的|此|拐點。|和其裁決:|那|它使主格|帶有 waw|更換|從|damma，|和使賓格|alef|更換|從|罰的罵|和使所有格|與閻|更換|從|kasra。|然後示例|名詞的|五|主格|(如果|命令你|你的父親|然後服從他)|RD|(到達|你的兄弟|從|他的旅行)|然後每個|從|(你的父親)|RD|(你的兄弟)|主格，|然後為它|是活躍的元素，|和標誌|它主格的|waw|更換|從|damma，|因其|是從|名詞|五、|和 kaaf|擁有|到它，|結構|後|罰的罵|於|一個地方|所有格。|和一個例子|名詞的|五|賓格|(服從|你的父親)|RD|(愛|你的哥哥)|然後每個|從|(你的父親)|RD|(你的兄弟)|賓格|因其|代理|在其上，|和標誌|其賓格的|阿勒夫|更換|從|罰的罵，|因其|是從|名詞|五、|和 kaaf|擁有|到它，|結構|後|罰的罵|於|所有格，|正如|以前。|和一個例子|名詞的|五|所有格|(聽著|到|你的父親，|同情/關注|與關於|你的哥哥)|然後每個|從|(你的父親)|RD|(你的兄弟)|所有格，|用於輸入|粒子|所有格的|在其上，|和標誌|其所有格的|是啊|更換|從|kasra，|因其|是從|名詞|五、|和 kaaf|擁有|到它|正如|以前。
GreatMasterpiece36=拐點|動詞的|五|它說:|和|動詞|五|然後它使陳述語氣|中午，與|和使虛擬語氣|和使命令心情|刪除它。|我說:|第四|從|事情|其中|活用|用字母|(動詞|五)|和肯定|你理解|在什麼|上一步|真正的意義|動詞的|五。|和其裁決:|它|讓陳述語氣|加|中午的|更換|從|damma，|和使虛擬語氣|和使命令心情|與刪除|這|中午|更換|從|罰的罵|或|蘇坤。|然後示例|動詞的|五|陳述語氣|(這兩個女人 / 你們倆寫)|RD|(這兩個女人你們兩個，理解)|然後每個|從他們|一個動詞|現在時態|陳述語氣，|剝離|從|虛擬語氣|與命令，|和標誌|它指示性的|新增|中午，|和阿勒夫|代詞的|第二人|活躍的元素，|結構|後|蘇坤|於|地方|指示性。|和一個例子|動詞的|五|虛擬語氣|(不會的|這兩個女人 / 兩個可以傷心)|RD|(不會的|這兩個女人 / 你們兩個失去勇氣)|然後每個|從這兩個|一個動詞|現在時態|虛擬語氣|將不，|和標誌|其虛擬語氣的|刪除|中午，|和阿勒夫|代詞的|第二人|使用中的元素|結構|後|蘇坤|於|地方|指示性。|和一個例子|動詞的|五|命令的心情|(沒有|這兩個女人 / 兩個你學習)|RD|(沒有|這兩個女人你們兩個，理解)|然後每個|從這兩個|一個動詞|現在時態|命令的心情|與沒有，|和標誌|其命令的|刪除|中午，|和阿勒夫|代詞的|第二人|使用中的元素|結構|後|蘇坤|於|地方|指示性。|演習/練習|1-|付諸表決|每個|word|從|單詞|給出了|於|一個句子|有意義|其中|它是|賓格|和是指|標誌|它的賓格:|天氣，|灰塵，|路|那根繩子，|燃燒，|棉花，|學校，|兩個穿著，|真誠致力，|穆斯林婦女，|我的父親，|殿下，|滿意。|2-|付諸表決|每個|word|從|單詞|給出了|於|一個句子|有意義，|其中|它是|所有格，|和是指|標誌|它的所有格:|你的父親，|有禮貌，|堅定|在他們的義務，|野獸的祈禱，|Ahmad，|一輪/圓，|門，|這兩個棕櫚樹，|兩只老鼠，|法官，|人類。|3-|付諸表決|每個|word|從|單詞|給出了|於|一個句子|有意義，|其中|它是|主格，|和是指|標誌|它主格:|其父母/父親和母親，|和平的使者，|指南 》，|戰士/奪寶奇兵|列祖，|母親，|剩下的人，|我的兒子，|你的哥哥。|4-|請參閱|於|標誌|給出了|語氣|和虛擬語氣|和命令的心情|從|動詞，|和主格|和賓格|和所有格|從|名詞，|並引用|含有|每個|一|標誌|它的拐點:|諮詢/颯颯忠告|歐麥爾|兒子|僕人|全能的上帝|於|成員|他雇用，|然後說:|給他|部分|他的朋友們:|你你身上使使用|與人民|責任，|和他說:|和誰|它們嗎?|他說:|那些|If|他們只是|然後它是|什麼|你曾希望，|如果|他們落在後面/過失無法|說|人:|當然|努力工作|歐麥爾。|帶來了|拉希德|一個男人|要負責的|判斷，|然後說:|對他說:|事實上|非|我很好|在判斷|而不是|I|是法理，|然後說:|(羅恩 ar-)拉希德:|在你|是三個|特徵/屬性:|給你|貴族|和貴族|防止|自己|從|被卑鄙平均值，|和為你|忍耐/忍耐|它可以防止你|從|時間倉促|和他的人|沒有|加速|有較少|錯誤。|5-|你是|一個男人|諮詢/尋求諮詢|於|您的建議/事項，|和誰|尋求意見|更多|這是正確的|至於|伊斯蘭法理學|它同夥子公司|給你|與他的人|你學習|有了它，|所以被關閉或朋友|所以不|他們發現|在它|一個地方的攻擊，誹謗，壞事。|5-|使在對偶形式|單詞|給出，|然後|使用|每|雙|於|兩個句子|有意義|因此|它是|於|一|從|這兩句話|主格，|和第二個|所有格。|墨水瓶，|父親，|花園裡，|這支筆，|這本書，|國家，|該研究所。|6-|使的複數形式|單詞|給出了|複數|男性|聲音，|和使用|每個|複數|於|兩個句子|有意義|與條件|那|它是|主格|於|這兩個第一|和賓格|於|其他:|義人，|研究，|懶惰的人，|虔誠的/上帝意識，|滿意，|默罕默德。|7-|付諸表決|每個|動詞|從|動詞|現在時態|給出了|於|三|個句子|有意義，|與條件|那|它是|陳述語氣|於|其中第一種，|和虛擬語氣|於|第二，|和命令的心情|於|第三:|他的戲劇，|他做|他的職責，|他們是疲倦/累/越來越無聊，|你女性參加，|他的希望|獎勵，|兩個旅行。|問題|到|幾個|組件|被劃分|屈折變化嗎?|對象|ㄧㄣ|屈折變化|其中|反映|與母音的跡象嗎?|對象|ㄧㄣ|屈折變化|其中|反映|用字母，|做例子|該名詞|單數|充分 inflectable|於|條件|主格的|和賓|和所有格，|並舉例說明|為複數形式|破碎的|諸如此類。|用什麼|讓賓格|複數形式|女性氣質|聽起來嗎?|做例子|為複數形式|女性氣質|聲音|於|條件|賓格的|和所有格。|用什麼|使得所有格|名詞|其中|非|是充分 inflectable 嗎?|做例子|該名詞|其中|非|是充分 inflectable|於|條件|所有格的|和主格|和賓格。|用什麼|使命令心情|動詞|現在時態|連接的|結局嗎?|做例子|為現在時態|連接的|結局|於|條件|命令。|對象|ㄧㄣ|屈折變化|其中|反映|用字母嗎?|與什麼|使得主格|雙嗎?|與什麼|讓賓格|和使所有格嗎?|用什麼|使得主格|複數形式|男子氣概|聽起來嗎?|與什麼|讓賓格|和使所有格嗎?|讓例子|為複數形式|男子氣概|聲音|諸如此類。|用什麼|你理解嗎|名詞|五|於|條件|主格的|和賓?|與什麼|這讓所有格嗎?|做例子|為名詞|五|於|條件|主格的|和賓格|讓例子|動詞|五|於|條件|三。
GreatMasterpiece37=動詞|與它種|它說:|(章|動詞)|動詞|有三個:|過去時態，|和現在時態|和命令緊張|就像:|他打了，|和他打嗎，|和命中。|我說:|被劃分|動詞|into|三|部件:|第部分|第一:|過去時態，|它是|什麼|被表示|後|獲取|事情|之前|時間|演講，|就像:|(他打了，|和他説明的所協助的|他開了，|他知道，|他認為/認為，|和他很大方)。|第部分|第二:|目前的緊張，|它是|什麼|被表示|後|獲取|事情|於|時間|演講，|或|在它之後，|就像:|(他命中，|和他説明/次助攻，|他打開|他知道，|他認為/認為，|他是慷慨)。|和部分|第三:|命令緊張，|它是|什麼|如下|與它|獲取|事情|之後|時間|演講，|就像:|(命中，|並説明或協助，|和開放，|知道，|想想/認為，|和慷慨)。|肯定|我們提醒|給你的|於|起始|這本書的|這些|部分，|我們提醒|給你的|與它|標誌|日|組件|從|這些|組件|三。
GreatMasterpiece38=裁決|動詞的|它說:|過去時態:|與罰的罵|結局|總是，|和命令緊張|命令|總是，|和現在時態|什麼|是|於|它的第一|一|增加的內容|四|其中|當加入到它的時候|你可以說:|(tah、 中午、 閻喉塞音符)|它是|主格|總是，|直到|進入|在上面|虛擬語氣|或|命令。|我說:|之後|那|是指|作者|類型|動詞的|開始|於|解釋|規則/法律|日|種類|從它。|當時的執政黨|動詞的|過去時態|是構建/固定|後|罰的罵，|與此|罰的罵|作為為|可見/明顯，|至於|應該。|對於|罰的罵|可見|然後在|聲音|結束|其中|沒有|附加|與它|waw|複數形式，|而不是|代名詞|主格|行動|諸如此類|於|每個|什麼|是|它的結局|waw|或|是啊，|就像:|(我感到很榮幸，|他介紹，|他旅行時)，|和一樣:|(旅行|贊，|和參加|薩阿德)|和一樣:|(他是高興的所滿意的|和他不高興)，|和一樣:|(他是光榮/高貴，|而且他用淫穢下流的語言)。|和|罰的罵|隱藏本應|然後它是|後|三|類型:|因其|作為為|那|ㄧㄣ|應該|為不可能的事，|與此|於|每個|什麼|是|它的結局|alef，|就像:|(他稱為/懇求，|和他奮鬥)|然後每個|從這兩個|是動詞|現在時態|結構|後|罰的罵|應該|後|阿勒夫|防止|從|其明顯|不是可能，|至於|那|ㄧㄣ|罰的罵|應該|適合適當性 /|和那|於|每個|動詞|過去時態|已連結|與它|waw|所述多個，|就像:|(他們寫道:|他們是快樂的)|然後每個|從這兩個|一個動詞|過去時態|結構|後|罰的罵|應該|後|它的結局|防止|從|其明顯|運作|在的地方|母音的跡象|適當的/合適，|和 waw|所述多個|含有|每個|從這兩個|使用中的元素|結構|後|蘇坤|於|一個地方|指示性，|至於|那|ㄧㄣ|罰的罵|應該|為連續|添加尾碼|在繼承|四|母音字母，|和那|於|每個|動詞|過去時態|已連結|與它|代詞|主格|移動，|像 tah|活動元素|到中午|女性的特質，|就像:|(寫道，|你陽剛寫道:|你女性寫道:|我們寫道:|她寫了)|然後每個|一|從|這些|動詞|一個動詞|過去時態|結構|後|罰的罵|應該|後|它的結局|防止|從|其明顯|運作|在的地方|蘇坤的|參展商/佔領|為連續|添加尾碼|在繼承|四|母音|在什麼|ㄧㄣ|像這個詞|一個人，|和 tah|或|(我們)|或|中午|是有源元件|結構|後|damma|或|罰的罵|或|kasra|或|蘇坤|於|一個地方|主格。|和執政的|動詞的|命令的時態:|結構/無詞形變化的結局|後|什麼|是由命令案例|與它|在其現在時態。|然後如果|是|它現在時態|聲音|它的結局，|它使命令案例|與蘇坤，|是|該命令|結構|後|蘇坤|與此|蘇坤|作為為|很明顯，|至於|應該，|然後蘇坤|表觀|為它|兩種情況下，|其中第一種:|那|ㄧㄣ|聲音|它的結局的|也沒有|附加|與它|任何事情，|和第二個:|那|高度重視|與它|中午|女性氣質|就像:|(打)|RD|(寫)|和像那樣|(打)|RD|(寫)|含有|連接的|到|中午|女性的特質，|和|蘇坤|應該|然後為它|案例|一個人，|它是|那|高度重視|與它|中午|重點|濃|或|光，|就像|(光強調的命中)|RD|(光強調的寫)|就像|(強強調的命中)|RD|(強強調的寫)。|如果|是|它現在時態|連接的|它的結局的|然後它|使命令心情|與刪除|這封信的|自身的缺陷，|然後命令|從它|生成|後|刪除|這封信的|自身的缺陷，|就像|(電話)|RD|(法官)|RD|(努力)。|如果|是|它現在時態|從|動詞|五|然後它|使命令模式|與刪除|中午，|然後命令|從它|生成|後|刪除|中午，|就像|(你們兩個寫)|RD|(你所有男性寫)|RD|(你女性寫)。
GreatMasterpiece39=Subjunctiveness|現在時態|它說:|然後 subjunctiveness|十年|和他們是:|到那，|和永遠不會 / 不會|和那時/因此，|並且，為了到所以，|和林|因此|和林|逃稅行為，|和直到/達，|和一個句子的回應，結論，扼要子句|與發|和 waw|和或。|我說:|組/顆粒|其中|劃分|在它以後|動詞|現在時態|十|顆粒|和他們是|在|三|部件:|部分|使虛擬語氣|與本身，|部分|使虛擬語氣|與那|已終結|在它以後|所允許的 (允許)|部分|使虛擬語氣|與那|已終結|在它以後|由必要性。|對於|第部分|第一個|-|它是|什麼|讓賓格|動詞|現在時態|與本身|-|然後四|顆粒|和他們是:|到那，|和永遠不會 / 不會|和那時/因此，|並且，為了向所以。|對於|(對...)|然後一個粒子|口頭|和虛擬語氣|和將來時態，|和它的例子|它說:|最高:|(我希望|那|將原諒|me)(26:82)|它說:|崇高|它提醒人們:|(而且我也不怕|那|他是吃|由 wolf)(12:13)|它說:|最高:|(真正|這讓我很傷心|那|你應該帶走|與 him)(12:13)|它說:|最高:|(和他們都同意|那|他們讓把他|於|底部|well)(12:15)。|和|(永遠不會 / 不會)|然後一個粒子|否定，|和虛擬語氣，|和將來時態，|和它的例子|它說:|最高:|(不會 / 不會再|我們相信|在 you)(2:55)|它說:|最高:|(不會的|停止|在上面|worshiping)(20:91)|它說:|最高:|(絕不意味著會不|你實現|righteousness)(3:92)。|和|(那時/因此)|然後一個粒子|答覆，|和獎勵|和虛擬語氣，|和所需|為虛擬語氣|現在時態|與它|三|條件:|第一:|那|ㄧㄣ|(那時/因此)|於|在胸部|這句話的|答覆。|第二種:|那|ㄧㄣ|現在時態|時間|在它以後|該值指示|後|未來。|第三:|那|非|分離|它之間|和之間|現在時態|分離|其他比/除外|宣誓|或|感歎詞|或|(不)|否定之否定|和示例|實現|條件|那|它說:|給你|一|您的兄弟:|(我就會努力工作|於|我的研究)|然後你說|對他說:|(那時/因此/因此|你就會成功)|和示例|分離的|與誓言|那|你說:|(然後|由阿拉|你一定會成功)，|和示例|分離的|與感歎詞|那|你說:|(然後|阿默罕默德|你一定會成功)，|和示例|分離的|與 laa|否定之否定|那|你說:|(然後|非|將不成功不成功|你的努力)|或|你說:|(然後|由阿拉|非|將去|你的工作|要浪費)。|和|因此，(為了)|粒子|口頭|和虛擬語氣，|和要求|於|虛擬語氣|與它|那|前面被句點|林|解釋|表達，|就像|它說:|最高:|(按順序，|你可能不是 grieve)(57:23)，|或|前面被句點|此|林|含義，|就像|它說:|最高:|(按順序，|非|它變得|fortune)(59:7)|然後當|沒有|在它前面|此|林|運算式|而不是|暗示|是|虛擬語氣|與那|隱藏，|和是|因此，(為了)|本身|一個粒子|解釋。|和|第部分|第二個|-|它是|其中|使虛擬語氣|動詞|現在時態|通過手段|(對...)|隱藏|可容許性|-|然後一個粒子|一個人，|它是|林|解釋，|和十字架|與它|作者|與林|所以，在訂購，|訂購兩個|於|辨識項|後|解釋，|和它的例子|它說:|最高:|(這可能原諒|給你|真主|什麼|來之前|從|你的罪|和什麼|來自 after)(48:2)|它說:|崇高|將|(所以，將懲罰|真主|hypocrites)(33:73)。|和|第部分|第三個|-|它是|其中|使虛擬案例|動詞|現在時態|通過手段|(對...)|隱藏|有必要|-|五|粒子:|第一:|林|逃稅行為，|它的控制器|那|它前面|含有|(不|是的)|或|(不|沒有)|然後示例|第一個|它說:|最高:|(不|將|真主|離開|信徒|後在|什麼|你|它目前 state)(3:179)，/|它說:|光榮:|(但不是|將|真主|懲罰 them)(8:33)|和示例|第二個|它說:|崇高|它的提醒:|(永遠不會|應|真主|原諒|他們|也不得|他引導他們|到任何正確的 way)(4:137)。|與顆粒|第三個|直到 (達)|它是|已使用|為目的/目標|或|解釋，|和意義|目標|那|什麼|在它之前|將完成它|獲取/由那|什麼|在它之後，|就像|說|真主|最高:|(直到|傳回|給我們|Moses)(20:91)|和意義|解釋|那|什麼|在它以後|原因|用於獲取|什麼|在它之後，|就像|你說:|對於一些|您的兄弟:|(研究|按順序對所以，|您傳遞)。|兩種顆粒與|第三個|和第四次:|美國聯邦航空局|推理，|和 waw|陪護，|與條件|那|位於|每個|從他們|於|回應|否定|或|要求|持續|否定|然後就像|它說:|最高:|(不|命中註定|對他們來說|然後他們將 die)(35:36)，|和|請求|然後八|事情:|命令必須|和懇求，|和禁止，|與質疑，|和演示文稿示範|和煽動行為，|與祝/欲望，|和希望及期望，|持續|請求|然後它是|該命令|發出|從|他具有重要意義的人|對誰|ㄧㄣ|沒有它，|就像|說|老師|對學生:|(研究|然後你將會成功/通)|或|(和你將會成功/通)|和|懇求|然後它是|要求|方向|從|渺小|到|最大/重大，|就像|(O 真主|指引我|所以我可以做|好)|或|(和我可以做|好)|和|預防|然後就像:|(不做|播放|因為失去了你|你希望)|或|(和你失去的|你的希望)，|和|質疑|然後就像:|(沒有|你記住|你的功課|所以我可以聽到它|從你)|或|(和我可以聽到它|從你)，|和|演示文稿或示範|然後它是|要求|由和藹，友善溫柔|就像:|(是|你看我們|所以我們可以榮譽/主機你)|或|(和我們可以榮譽/主機你)|和|煽動|然後它是|請求|含有|動機|和干擾|就像:|(沒有|你做|你的工作|所以，會感謝你|你的父親)|或|(和會感謝你|你的父親)，|和|希望/渴望|然後它是|請求|不可能，|或|什麼|在它|是困難，|就像|這句話|詩人:|但願|星星|被關閉或其附近|對我來說|所以能幫你安排一下|在項鍊/合同|讚美/美化|所以不|我很滿意|和你一起|我的詞語|和它的例子|說|結束:|那|但願|青春|將返回|一天|所以我可以通知他|什麼|沒有|年老時|和一樣:|但願|我有|貨幣|所以我可以執行麥加朝聖|與從它)，|和|希望及期望|然後它是|請求|命令的|附近的|發生|就像:|(也許|真主|會治癒我|所以我可以來拜訪你)。|肯定|收集|部分|科學家們的|這些|事情|九|其中|之前|美國聯邦航空局|和 waw|於|房子/線|一|它是:|命令，|和苦苦哀求，|和禁止，|問:|並展示禮物 /|對衝動/煽動/勸他們|願望，|希望/期待，|諸如此類|否定，|當然|完成|和肯定|記得|作者|它|八、|為此他|沒有|考慮|希望及期望|從他們。|粒子|第五個|(或者)|要求|於|此|這個詞|那|ㄧㄣ|與意義|(除外)|或|與意義|(對)|與控制器/規則|第一:|那|ㄧㄣ|什麼|之後|it|完成|在一個實例中/一次|就像:|(我會真的殺了|不通道的人|除非|他成為穆斯林)|與控制器/規則|第二:|那|ㄧㄣ|什麼|在它以後|完成|步驟或物|由一步/然後事情，|就像|說|詩人:|事實上我曾|困難|容易|要實現/到達|願望|所以不|指南|希望|除了|病人|練習/演習|1-|接聽|從|每個|個句子|從|句子|給出了|用兩句|於|每個|一|從這兩個|一個動詞|現在時態。|(仲裁)|對象|其中|延遲/刪除/暫停你|從|你的兄弟嗎?|() b|將|你去旅行|明天?|() c|如何|你會做|If|你想要|學習嗎?|() d|其中|食品|你喜歡嗎？|() e|where|生活|哈利勒?() f|內|其中|公園/遊樂場|你花了|一天|假期嗎?|() g|誰|是一個人|花|你嗎?|() h|幾個|小時|你花嗎|於|學習|每|一天嗎?|2-|付諸表決|於|每個|地方|從|地方|空閒|一個動詞|現在時態|然後|參照|其類型|從|拐點|RD|標誌|它的拐點:|(仲裁)|我來|昨天|......|然後不|找到了你。|() b|它讓我開心|那|......|() c|我愛|阿裡|因為他|......|() d|不會|......|工作|今天的|到|明天。|() e|你們兩個|......|哈立德。|() f|我去拜訪你的兩個|所以，在到訂單|......|和我一起|到|公園/遊樂場。|() g|給你|那些人|......|家庭作業。|() h|Not|你將會|虔誠/真誠|直到|......|你的行為。|() i|他的人|想要|......|他自己|不應該|落在後面/被忽視|於|他的家庭作業。|() j|很抱歉|在我身上|那|......|() k|加速|走了的路|因此|......|第一個|工作。|() l|不會|......|罪人|從|處罰。|() m|堅持持續存在|後|你的工作|因此|......|() n|執行|你的職責|所以，在到訂單|......|後|快樂|真主|() o|他們離開|這場比賽|......|() p|如果不是|那|......|在你身上|我本來要求/期望從你|要上癮|上班。|問題|對象|現在|工具|其中|使虛擬語氣|現在時態|與本身嗎?|對象|是的意義|(對...)|和什麼|是的意義|(將不要)|和什麼|是的意義|(那時/因此)|和什麼|是的意義|(按順序向所以的)?|對象|其中|要求|為虛擬語氣|現在時態|之後|(那時/因此)|前後|因此，(為了) 嗎?|對象|現在|事情|其中|非|危害|分離|與它|介於|(那時/因此)|虛擬語氣|和現在時態?|當|使虛擬語氣|(對...)|隱藏|允許的嗎?|當|使虛擬語氣|(對...)|隱藏|有必要嗎?|對象|是的控制器|之林|逃稅嗎?|對象|是的意義|(直到)|虛擬語氣?|對象|現在|事情|其中|必須|那|先于|一|從他們|fah|推理的|或|waw|陪護嗎?|做例子|為每個|什麼|你學習它。
GreatMasterpiece40=命令|現在時態|它說:|和命令|八|十、|和他們是:|沒有，|並不是什麼，|也沒有，|和什麼不一樣，|和林|命令|和懇求，|RD|(不做)|於|禁止|和懇求，|和，如果，|和什麼，|和誰，|無論，|每當 / 如果|什麼，|而，|時候，|在哪裡|和下落，|和這樣，|何地，|然而，|和那時/因此|於|詩歌|具體。|我說:|工具|其中|使命令的心情|動詞|現在時態|八|十|命令，|和這些|工具|除|到|兩個部分:|第部分|第一，|每個|一|在它|使命令心情|一個動詞|一個人，|和部分|第二個|每個|一|從它|使命令心情|兩個動詞。|對於|第部分|第一，|然後六|顆粒，|和他們是:|沒有，|和做的時候，不|也沒有，|和什麼不一樣，|和林|命令|和懇求，|RD|(不做)|於|禁止|和懇求，|和他們每個人都|顆粒|與共識|語法。|對於|(沒有)|然後粒子|否定之否定|和命令|和改變，|就像|它說:|最高:|(不|被|那些人|disbelieved)(98:1)|它說:|最高:|(說|沒有|你 believe)(49:14)。|和|(沒有不/時)|然後粒子|看起來像|(沒有)|於|負|和命令|和改變，|就像|它說:|最高:|(當然|不還|味道|處罰)。|和|(沒有)|然後它是|(沒有)|已加入|在上面|哈姆紮|建立，|就像|它說:|最高:|(沒有|我們打開|給你的|你的 chest)(96:1)。|和|(沒有)|然後它是|(沒有不/時)|已加入|在上面|哈姆紮|就像|(沒有|我做得好|到你)。|和|林|然後當然|提到|作者|它|是|命令|和懇求，|和每個|從|該命令|祈求|註定|由它|請求|發生/發生|動詞的|請求|命令，|與差異|兩者之間|那|該命令|ㄧㄣ|從|最高|到了最低水準|就像|於|聖訓 》:|(然後說|好|或|保持沉默)|和|懇求|然後它是|從|最低|到最高，|就像|它說:|最高|(使兩端/殺|在我們身上|你的 Lord)(43:77)。|和|(不做)|然後當然|提到|作者|它|如下|為禁止|和懇求，|和每個|從這兩個|是指|與它|請求|避免人棄權的|從|操作的動詞|和離開它，|與差異|兩者之間|那|禁止|ㄧㄣ|從|最高|到了最低水準，|就像:|(不做|fear)(51:28)|和一樣:|(不做|說|支付給我們聽從/聽 us)(2:104)|和一樣:|(不做|誇大|於|你的 religion)(4:171)，|和|懇求|然後是|從|最低|到最高|就像:|(我們的主|非|對 us)(2:286) 的地方/躺著|它說:|崇高|將:|(而不是|地方|我們|burden)(2:286)。|和|第部分|第二:|它是|什麼|它使命令的心情|兩個動詞，|和電話|這兩個第一|動詞|條件下，|和兩個第二|回應|條件|和它的獎賞，|它是|後|四|種類:|那種|第一:|一個粒子|根據協定，|和那種|第二:|一個名詞|根據協定，|和那種|第三:|一個粒子|後|更正確，|和那種|第四:|一個名詞|後|更正確。|對於|那種|第一:|然後它是|(如果)|只，|就像:|(如果|你研究修訂|然後你會傳遞/成功)|然後如果:|粒子|條件|命令|由協定|語法，|它使命令的心情|兩個動詞，|第一; 首先|動詞|條件|和第二個|其回應|和它的獎賞，|RD|(研究/修改)|一個動詞|現在時態|動詞|條件|命令的心情|如果|和標誌|其命令的|蘇坤|和其積極的元素|代詞|隱藏|在它|現有|其隱含|你，|RD|你將通過 (成功)|一個動詞|現在時態|回應|條件|和它的獎賞，|命令的心情|如果|和標誌|其命令的|蘇坤|和其積極的元素|代詞|隱藏|在它|現有|其隱含|你。|那種|第二個|它是|協定 》|後|它|是一個名詞|-|然後 9|名詞，|和他們是:|誰，|和什麼，|而，|時候，|和下落，|在哪裡，|和這樣，|何地，|但是。|然後示例|(誰)|你說:|(他的人|榮譽|他的鄰居|會受到表揚)，|或|(他的人|修改|將通過/成功)|它說:|最高|(然後誰|沒有|重量|一個原子|好的|將會看到 it)(99:7)。|然後示例|(什麼)|你說:|(什麼/那的|你產生了|你將會|與它)|RD|(什麼/那的|你讀|你將受益|從它)|RD|(這其中|你做|/|好|將完全償還|到你)。|和一個例子|(其中)|你說:|(任何|書|你讀|你將受益|從它)|RD|(其中|什麼|你叫|然後為他|名稱|best)(17:110)。|和一個例子|(時)|你說:|(當|你觀察/採取謹慎|到的|你的職責|您將被授予|快樂|你們的主)|和這句話|詩人:|我是|兒子|著名/著名|高之一|願望|當|我穿上|我的頭巾: 頭部覆蓋物|你知道/認識我，|和一個例子|(時)|你說:|(當|你會滿足我|我將以你為榮)，|和這句話|詩人:|所以當|什麼|你轉身離去|從它|的氣味|減少/減少|和一個例子|(無論)|你說:|(無論|你的頭去|你滿足|一位朋友)|它說:|最高:|(無論|他指示他|非|他會帶來呢|任何 good)(16:76)|RD|(無論|你是|將取代你|death)(4:78)|和一個例子|(無論)|這句話|詩人:|無論在哪裡|你站在直立適當糾正|將法令|給你的|真主|成功|於|過去/老/一切|次|和一個例子|(然而)|你說:|(然而|將|國家/伊斯蘭世界|會有|領導/統治者)|RD|(然而|ㄧㄣ|你的意圖|將|獎勵|真主|為你)|和添加|後|這些|名詞|九|當 (如果)|於|詩歌|像什麼|說|作者，|和那|必要性|就像|這句話|詩人:|滿意|什麼|是給你的|你的主|財富|和什麼時候|你被所困擾|貧困|然後要有耐心|和|那種|第三個|-|它是|什麼|不同/爭執|於|它|是一個名詞|或|一個粒子，|更正確|它是|一個粒子|-|然後，|一個粒子|一|它是|(無論何時)|和一個例子|這句話|詩人:|實在|每當|你做|這其中|您|命令|由它 (好好)|你會發現|他的人|給他|被吩咐|將做它|和|那種|第四個|-|它是|什麼|不同/爭執|於|它|是一個名詞|或|一個粒子，|更正確|它是|一個名詞|-|然後，|是一個詞|一個人，|它是|(無論)|和它的例子|它說:|最高:|(和他們 (Moses 國家) 說:|無論|你可能會帶給我們|與它|從|標誌|為了迷惑我們|與它|然後不|我們|在你|我們要去 believe)(7:132)，|和這句話|詩人:|和實在|無論|你給|你的胃|是什麼它的願望/要求|和你的私處|獲取|結束/最大|中傷/誹謗|收集|演習/練習|1-|指定引用到|動詞|存在|時態/時間|於|句子|給出，|然後|請參閱|陳述語氣|從他們|和虛擬語氣|和命令的心情，|和是指|標誌|它的拐點:|他的人|植物|好|豎琴/收穫|好|......|不要|變慢|於|你的責任/義務|......|你要當心|那|飲用|雖然你|是用盡了累了|......|很多/過度|笑的|使枯萎死 /|心|......|他的人|輪流遠離|真主|轉過身去|真主|從他|......|If|你堅持下去|後在|工作|然後你會贏|......|他的人|沒有|知道|權利|人|在他結束|沒有|知道|人民|他的權利|在他們以上|......|無論|你努力|你會發現|寄託|......|無論|去|之前科學家的學者|尊重他|人民|......|非|它是適用于|為私密金鑰的持有人|男子氣概和慷慨的|那|以是開玩笑的|好多|......|然而|你將會|將領導/老闆/頭會怎麼樣|在你身上|......|If|你保存/商店/就丟在一邊|這筆錢|你將受益|......|If|你是|疏忽|變得更糟|你的條件|......|無論|你隱藏/隱藏|將暴露出來它|天|......|不要|被|愛講閒話/嘮叨的人|所以你不會不開心/悲慘。|2-|Enter|每個|動詞|從|動詞|現在時態|給出了|於|三|句子，|與條件|那|ㄧㄣ|陳述語氣|於|一|從他們，|和虛擬語氣|在第二個，|和命令的心情|在第三。|你她培養，|你她旅行，|你她玩，|你她出現，|你所有的愛，|你女性的飲料，|你們兩個/兩個女人去，|你她希望，|他說話的口氣不理性/神志不清，|你她接受。|3-|付諸表決|於|每個|地方|從|地方|空閒|從|例子|給出了|一個粒子|條件|適合/適當:|(仲裁)|......|你將參加|將出席|你的父親。|() b|......|你會善待別人|我會和他交朋友。|() c|......|你玩|你會後悔。|() d|......|你隱藏|將顯示給他|你的作品。|() e|......|你走|我去|與你。|() f|......|你學習|在它|它將使你受益。|4-|完整安裝|句子|給出了|地位|動詞的|現在時態|適當情況下，|和調整|它的結局:|(仲裁)|If|你犯下的罪|......|() b|If|瀑布|玻璃|......|() c|無論|你做|......|() d|任何|人員|你成為我們的朋友|......|() e|If|你把|鹽|於|水|......|() f|無論|你走|......|() g|然而|將|一個人|......|() h|誰|訪問我|......|() i|每當|ㄧㄣ|這位學者|......|() j|無論|去|這位學者|......|5-|完整安裝|從|每個|兩個句子|按比例|從|句子|給出了|一個句子|其原理|含有|粒子|條件|為他們相稱:|你注意|到|這一課|如果你堅持|電線|電力，|你將到達|很快，|你將受益|從它，|你開車|一輛車，|你會震撼，|你關閉|windows|你的房間，|你做|你的職責，|瀑布|雨中，|會變得陳舊|空氣中，|他會贏|安居樂業|人，|開啟|把傘。|問題|進入|幾個|組件|劃分|粒子的命令的心情嗎?|對象|現在|粒子的命令的心情|其中|使命令的心情|一個動詞|其中一個嗎?|對象|現在|顆粒|命令的心情|其中|使命令的心情|兩個動詞?|請參閱|對名詞|同意|後|其名義/名詞形式|和顆粒|同意|後|其顆粒狀|從|粒子的命令的心情|其中|使命令的心情|兩個動詞，|讓|為每個|命令的粒子|使命令的心情|一個動詞|一|用兩個例子，|並給出|為每個|命令的粒子|使命令的心情|兩個動詞|含有|示例|一|顯示/顯示|在它|動詞|條件|和應對的答案。
GreatMasterpiece41=數位|主格的案件|和他們的例子|它說:|(章|主格例的|名詞)|主格例|7、|和他們是:|活躍的元素，|和物件|其中|非|一直叫|它的主題，|問題，|和謂語，|和的名詞|(是) / 動詞是|和它的姐妹，|和的謂詞|(當然) / 賓格粒子|和它的姐妹，|和追隨者|主格的|它是|四|事情:|形容詞，|和一起，|並強調，|和替代。|我說:|當然|你知道的|用什麼|是一種過去|那|名詞|屈折變化|位於|於|三|地點:|位置|主格的|和位置|賓格的|和位置|所有格，|和每個|一|從|這些|位置|要素的原因|是必需的|和肯定|開始|作者|解釋|給你|那|後在|詳細資訊，|和開始|與提|主格的個案中，|因為，他們|是最傑出的|和肯定|提到|那|名詞|ㄧㄣ|主格|於|七|類型。|1-|當|是|活躍的元素，|和它的例子|(阿裡)|RD|(穆罕默德)|於|就像|你說:|(出席|阿裡)|RD|(旅行|默罕默德)。|2-|這|ㄧㄣ|替代/代表|從|活躍的元素，|它是|這其中|被稱為|作者|物件|其中|沒有|名稱/電話|它的主題，|就像|(分支)|RD|(商品)|從|你說:|(被切斷|分公司)|RD|(被偷了|商品)。|3，|4-|主題|和謂語，|就像:|(默罕默德|是一個旅行者)|RD|(阿裡|是一個勤勞的工人)。|5-|名詞|(是) / 動詞是|或|一|它的姐妹|就像:|(亞伯拉罕)|RD|(冷)|從|你說:|(是|亞伯拉罕 ·|一個勤勞的工人)|RD|(成為了|寒冷|嚴重)。|6-|謂詞的|(如果)|或|一|它的姐妹，|就像:|(優秀)|RD|(強大)|從|你說:|(實在|默罕默德|是優秀)|RD|(肯定/的確|真主|是經一遍|全部|事情|功能強大)。|7-|從動件|主格的|和追隨者|四|種類:|第一; 首先|形容詞，|和那|就像:|(尊敬)|RD|(光榮/慷慨)|從|你說:|(拜訪了我|默罕默德|尊敬)|RD|(遇見我|一個男人|光榮/慷慨)，|和第二個|連詞，|它是|後|兩個部分:|連詞|實地調查，|和連詞|協調，|然後示例|結合|實地調查|(歐麥爾)|從|你說:|(旅行|父親|哈夫斯|歐麥爾)|和示例|結合|協調|() Khalid|從|你說:|(參加|默罕默德|和哈立德)|第三個|強調，|和它的例子:|(自己)|從|你說:|(拜訪了我|領導者的王子/指揮官|他自己)|第四|取而代之，|和它的例子|(你的兄弟)|從|你說:|(是目前/出席|阿裡|你的弟弟)。|如果|你放在一起|這些|粉絲|他們每個人都|或|其中一些|於|語音|第一把|形容詞，|然後|連詞|實地調查，|然後|強調，|然後|取而代之，|然後|連詞|協調，|你說:|(來了|男子|尊貴大方|阿裡|他自己|你的朋友|和他的弟弟)。|練習|在關於|拐點|活用|例子|給出:|(亞伯拉罕|是忠實/真誠，|和是|你的主|都是強大的|真正|真主|是聽話人|所有懇求)。|答覆|1-|(亞伯拉罕)|是一門學科，|主格|按主題、|和標誌|它主格的|damma|很明顯，|(忠實/真誠)|謂詞|為主題，|主格|按主題、|和標誌|它主格的|damma|明顯。|2-|(是)|一個動詞|過去時態|不規則，|使得主格|名詞|和使賓格|謂詞，|(主)|名詞|動詞，是的|主格|通過它，|和標誌|它主格的|damma|很明顯，|和主|附加所擁有，|和 kaf|代詞|處理/二人|連接藏有|到它，|結構|後|罰的罵|於|地方|所有格，|(都是強大的)|謂詞|動詞，是的|賓格|通過它，|和標誌|其賓格的|罰的罵|明顯。|3-|(真誠)|一個粒子|重點|和賓格|(真主)|名詞|真正賓/粒子|賓格|通過它，|和標誌|其賓格的|罰的罵|很明顯，|(聽話人)|謂詞|賓格助詞的|主格|通過它，|和標誌|它主格的|damma|很明顯，|和聽話者|附加所擁有，|RD|(指所有的懇求)|連接藏有|到它，|所有格|由附件/藏建設|和標誌|其所有格的|kasra|明顯。|問題|內|幾個|種類|是|名詞|主格?|對象|種類|追隨者嗎?|如果|組合|重點|和連詞|實地調查|形容詞和|那麼如何|是他們安排嗎?|如果|組合|追隨者|所有這些|那是什麼|其中|是第一位|從他們嗎?|給|為主題|和謂語|用兩個例子，|成為|為每個|從|名詞|動詞對 be/(was)|和謂詞|賓格 particle/(truly) 的|和活動元素|及其替代品|兩個例子。
GreatMasterpiece42=它說:|(章|活性元素)|活動元素|它是:|名詞，|主格，|一提|在它之前|其動詞。|我說:|活動元素|為它|兩層含義:|這兩個第一|詞彙/語言/文字|和第二個|術語/技術/理論。|對於|它的意思|於|詞彙|然後它是|一個短語的單詞/運算式|關於一個|把關于造成|一種操作。|和|它的意思|於|術語|然後是:|名詞|主格|提到|在它之前|它的行動，|像什麼|曾說|作者。|和我們說|(名詞)|非|包括|動詞|而不是|粒子，|然後不|是|一|從這兩個|活躍的元素，|和它|包括|名詞|清晰|和名詞|解釋|與清除:|持續|清除|然後就像:|(諾亞)|RD|(亞伯拉罕)|於|它說:|最高:|(說|Noah)(71:21)，|(和時|引發|Abraham)(2:127)，|和|解釋|與清除|就像|它說:|最高:|(這並不|對他們來說足夠|那我們|revealed)(29:51)，|然後:|一個粒子|重點|和賓格|RD|(我們)|其名詞|結構|後|蘇坤|於|地方|賓格的|RD|(我們透露)|一個動詞|過去時態|和其積極的元素，|和這句話|於|地方|主格的|謂詞|，賓粒子|RD|(，)|和什麼|輸入|在上面|於|解釋|分詞/不定式|活動元素|(它是足夠)|並暗示:|這並不|對他們來說足夠|我們揭示，|和它的例子|你說:|(這讓我高興|那|你抓住/繼續對|美德和道德卓越)|和你說:|(它驚訝/使我吃驚的|什麼|你製作)，|含義|在他們，|它讓我開心|你抓住/堅持，|和它驚訝/使我吃驚的|你的生產。|和我們說:|(主格)|拿出/提取物|這其中|是|賓格|或|所有格，|然後不|ㄧㄣ|一|從他們|活躍的元素。|我們說:|(提到|在它之前|其動詞)|拿出/提取物|主題|和的名詞|(賓格粒子/真實地)|和它的姐妹，|為確|非|他們前面的是由|動詞|確定性，|它又出/提取物|還|名詞|(是動詞要)|和它的姐妹，|和的名詞|(將附近/點)|和它的姐妹;|然後當然這兩個|如果|前面兩個|一個動詞|然後如果|此|動詞|不是|一個動詞|一|從他們兩人，|和本來是準備|由動詞|那是的|包括|什麼東西像|動詞|像這個名詞|口頭|於|就像:|(多遠|是峽谷的峽谷/山谷)|RD|(多麼不同|是紮伊|和 Amr)|和分詞|使用中|於|它就像|(來|你的父親)|然後峽谷/峽谷/山谷，|和 Zayd|含有|什麼|附加傾向于|在其上，|和你的父親:|每個|從它|活躍的元素。
GreatMasterpiece43=部分|活動元素的|和類|明顯|從它|它說:|它是|後|兩個部分:|很明顯，|和隱藏，|然後明顯|就像|你說:|站在|宰，|和站|宰，|和站在那裡|兩個 Zayds，|和站|兩個 Zayds，|和站在那裡|Zayds，|和站|Zayds，|和站在那裡|男人，|和站|男人，|和站在那裡|後腿，|和站|後腿，|和站在那裡|兩個海因茲，|和站|兩個海因茲，|和站在那裡|不要驚動，|和站|海因茲|和站|不要驚動，|和站在那裡|你的父親，|和站在那裡|小男孩奴隸|和站|小男孩奴隸|和什麼|是類似于|那。|我說:|劃分|活動元素|into|兩個部分:|第一; 首先|表觀|和第二個|隱藏，|然後為|表觀|然後是:|這其中|是指|後|它的意思|和其他無|需要|到|上下文連接，|和|隱藏|然後是:|這其中|沒有|參照|後|目的|從它|除了|與上下文，連接關聯|對一位發言者 / 1 人|或|其中之一是處理/2 人|或|一個人是缺席/3 人。|和明顯|後|類型:|因其|作為為|那|ㄧㄣ|單數|或|雙|或|表單|複數|聲音|或|複數|破碎的|和每個|從|這些|類型|四|作為為|那|ㄧㄣ|男性|作為為|那|ㄧㄣ|女性;|然後這些|八|類型，|和也|然後為|那|ㄧㄣ|其拐點|與 damma|表觀|或|應該，|和|那|ㄧㄣ|其拐點|用字母|替代|從|damma，|和後|每個|這些|條件|作為為|那|ㄧㄣ|動詞|過去時態，|和|那|ㄧㄣ|現在時態。|然後示例|活動元素的|單數|男性:|含有|動詞|過去時態|(出席|這兩個朋友，|和參加|哈立德)|和與|動詞|現在時態|(遊記|默罕默德，|並出席|哈立德)。|然後示例|活動元素的|雙|男性:|含有|動詞|過去時態|(出席|這兩個朋友，|和移動|兩兄弟)|和與|動詞|現在時態|(出席|這兩個朋友，|和旅行|兩兄弟)。|和示例|活動元素|表單|複數形式|健全性|對於男子氣概|含有|動詞|過去時態|(出席|穆罕默德，|和執行的朝聖|穆斯林)|和與|動詞|現在時態|(出席|穆罕默德，|和執行朝聖之旅|穆斯林)。|和示例|活動元素的|表單|複數形式|破碎的|-|它是|男性|-|和與|動詞|過去時態|(出席|朋友們，|和移動|領導人)|和與|動詞|現在時態|(出席|朋友們，|和旅行|領導人)。|和示例|活動元素的|單數|女性:|含有|動詞|過去時態|(出席|後腿，|旅行|薩阿德)|和與|動詞|現在時態|(出席|後腿，|和旅行|薩阿德)。|和示例|活動元素的|雙|女性:|含有|過去時態|(出席|兩個海因茲，|和移動|兩個 Zaynabs)|和與|現在時態|(出席|兩個海因茲，|和旅行|兩個 Zaynabs)。|和示例|活動元素的|表單|複數形式|健全性|女性:|含有|過去時態|(出席|不要驚動，|和移動|) Zaynabs|和與|現在時態|(出席|不要驚動，|和旅行|Zaynabs)。|和示例|活動元素的|表單|複數形式|破碎的|它是|女性:|含有|過去時態|(出席|不要驚動，|和移動|) Zaynabs|和與|現在時態|(出席|不要驚動，|和旅行|Zaynabs)。|和示例|活動元素的|其中|其拐點|是 damma|表觀|一起|從那的|來之前|於|例子|其中|除了|雙|男性|和女性|和複數|酣然|為男性。|和示例|活動元素的|其中|其拐點|與 damma|應該，|含有|動詞|過去時態|(出席|那個男孩)|RD|(旅行|法官)|RD|(接受|我的朋友)|和與|動詞|現在時態|(出席|那個男孩)|RD|(遊記|法官)|RD|(接受|我的朋友)。|和示例|活動元素的|其中|其拐點|與這封信|而代以|從|damma|什麼|來之前|從|範例|動詞的|雙|男子氣概|或|女性的特質，|和示例|動詞的|表單|複數|酣然|對於男子氣概，|和從|他們的例子|此外，|含有|過去時態|(出席|你的父親，|和移動|你的哥哥)|和與|現在時態|(出席|你的父親，|和旅行|你的弟弟)。
GreatMasterpiece44=種類|活動元素的|隱藏|它說:|隱藏|是兩個|十、|就像|你說:|(我打，|和我們打，|和你陽剛打，|和你女性的命中，|和你兩個打，|和你所有男性打，|和你所有女性打，|和他打了，|和她打，|和他們兩個打，|和他們陽剛打，|和他們女性打)。|我說:|當然|你知道的|在什麼|來之前|隱藏|什麼|它是，|現在|這是眾所周知的你|它|後|二|十|種類:|和那|因為它|作為為|那|是指|後|一位發言者，|至於|那|是指|後|每秒處理的人，|至於|那|是指|後|另一/三人，|而|是指|後|一位發言者/第一人稱，|各不相同|到|兩種:|因為它|作為為|那|ㄧㄣ|演講者/第一人|一個人，|至於|那|ㄧㄣ|更多資訊|於|一個人，|而|參照|後|每秒處理人|或|其他/三人|變化|每個|其中|到|五|類，|因為它|作為為|那|是指|後|單數|男性，|至於|那|是指|後|單數|女性，|至於|那|是指|後|雙|不受限制，|至於|那|是指|後|複數|男性，|至於|那|是指|後|複數|女性|然後是|表單|二|十。|然後示例|代詞的|演講者/第一人|一個人，|男性|是|或|女性|(一打)|RD|(背下)|RD|(我是工作硬/勤奮)。|和示例|代詞的|演講者/第一人|超過一個/多個|或|一|誰|尊榮|他自己|和它放在|位置|組的|(我們襲擊了)|RD|(我們記憶)|RD|(我們都努力工作，勤奮)。|和示例|代詞的|處理/二人|一|男性|(你男性襲擊了)|RD|(你男性記憶)|RD|(你都工作硬/勤奮)。|和示例|代詞的|處理/二人|一|女性|(你襲擊了女性)|RD|(你女性記憶)|RD|(你都工作硬/勤奮)。|和示例|代詞的|處理/二人|二|男性|或|女性|(你襲擊了兩個)|RD|(你們兩個能記住)|RD|(你都努力工作，勤奮)。|和示例|代詞的|處理/二人|從|複數|男性|(你所有男性襲擊了)|RD|(你所有男性記憶)|RD|(你所有男性都工作硬/勤奮)。|和示例|代詞的|處理/二人|從|複數|女性|(你所有女性擊中了)|RD|(你所有女性記憶)|RD|(你所有女性都工作硬/勤奮)。|和示例|代詞的|之一|男性|其他/三人|(他擊中，擊中，節拍)|於|你說:|(默罕默德|打，打，打|他的弟弟)|RD|(他能記住)|於|你說:|(亞伯拉罕|記憶|他的課)|RD|(他是工作硬/勤奮)|於|你說:|(哈立德|工作辛苦/勤奮|於|他的工作)。|和示例|代詞的|一|女性|三人|(她用力地打)|於|你說:|(後腿|襲擊了|她的妹妹)|RD|(她能記住)|於|你說:|(薩阿德|記憶|她的課)|RD|(她是工作硬/勤奮)|於|你說:|(贊|工作辛苦/勤奮|於|她的工作)。|和示例|代詞的|二|其他/三人|男性|是|或|女性|(他們襲擊了兩個)|於|你說:|(兩個穆罕默德|襲擊了|巴克爾)|或|你說:|(兩個不要驚動|襲擊了|阿米爾)|RD|(他們兩個記憶)|於|你說:|(兩個穆罕默德|記憶|他們兩個的教訓)|或|你說:|(兩個不要驚動|記憶|他們兩個的教訓)|RD|(他們兩個正在努力勤奮)|從|就像|你說:|(兩個 Bakrs|是努力工作，勤奮)|或|你說:|(兩個 Zaynabs|是努力工作，勤奮)|RD|(他們兩個站)|於|就像|你說:|(兩個穆罕默德|沒有|他們兩個的職責)|或|你說:|(兩個不要驚動|沒有|他們兩個的職責)。|和示例|代詞的|其他兩個/第三人|從|複數|男性|(他們陽剛節拍/打)|從|就像|它說:|(男人|拍擊擊中|他們的敵人)|RD|(他們陽剛記憶)|從|就像|它說:|(學生|記憶|他們的課程)|RD|(他們男性工作努力勤奮)|從|就像|你說:|(學生|是的工作硬/勤奮)。|和示例|代詞的|其他/三人|從|複數|女性|(他們女性節拍/打)|從|就像|你說:|(女孩|拍擊擊中|他們的敵人)|和像那樣|(他們女性記憶)|從|就像|你說:|(婦女|保障|他們的信任)|和像那樣|(他們女性工作努力勤奮)|從|就像|你說:|(女兒/女孩|是的工作硬/勤奮)。|和每個|這些|種類|二|十|上一步|呼叫|代詞|在他們|(代詞|附後)|和眾所周知的|它|is:|其中|沒有|開始|與它|這個詞|而不是|顯示來|之後|(除外)|於|條件/箱|選擇/常用的演講。|和它的例子|給出了|於|種類|結局|從|代詞|被稱為|(代詞|分隔所分離)|和它是:|其中|到職|與它|又出現 /|之後|(除外)|於|條件/箱|選擇/常用演講的|你說|(不|他擊中了|除了|我)|RD|(不|他擊中了|除了|我們)|RD|(不|他擊中了|除了|你陽剛)|RD|(不|他擊中了|除了|你女性)|RD|(不|他擊中了|除了|你們兩個)|RD|(不|他擊中了|除了|你所有的男性)|RD|(不|他擊中了|除了|你所有女性)|RD|(不|他擊中了|除了|他)|RD|(不|他擊中了|除了|她)|RD|(不|他擊中了|除了|兩個)|RD|(不|他擊中了|除了|他們男性)|RD|(不|他擊中了|除了|他們女性)。|後|此|如下|比喻。|和會|有人指出|種類|代詞的|分離/拆|更多/更詳細|從|這些|標誌|於|這一章|主題|和謂詞。|演習/練習|1-|車廠|每個|名詞|從|名詞|給出了|使用中的元素|於|兩句話，|與條件|那|ㄧㄣ|動詞|過去時態|於|一個兩個，|和一般現在時|於|其他:|你的哥哥。|你的朋友。|商人。|真誠的人。|我的兒子。|老師。|這棵樹。|春天。|好。|2-|給|含有|每|動詞|從|動詞|給出了|兩個名詞，|和使|每個|一|從他們|使用中的元素|為它|一個句子|適用于:|他參加了。|他買了。|他獲得了贏利/韓元。|他救了。|他成功了。|他沒有/形式。|她的果子。|他的方法/臨近。|他哀叫一聲/嘶叫。|3-|接聽|從|每個|問題|從|問題|給出了|同一個句子|有意義|內含|後|一個動詞|和積極的元素:|(仲裁)|當|你旅行嗎?|() b|其中|正在|你的雇主?|() c|沒有|參加|你的哥哥嗎?|() d|如何|你找到了嗎|這本書嗎?|() e|什麼|你做了嗎?|() f|當|我將見到你嗎?|() g|其中|你將花費|本賽季|夏天嗎?|() h|什麼|其中|你正在學習它?|4-|車廠|從|這個詞|給出了|一個句子|包括|每個|一|從他們|後|一個動詞|和積極的元素:|他成功了。|他贏了。|他溢出。|他變得柔和了。|勤勞的工作者。|真誠。|花。|尼羅河。|商人。|運動|後|拐點|活用|句子|給出:|出席|默罕默德。|旅行|所選擇。|會來看我們|法官。|我接受|我的弟弟。|答案/回應|1-|出席|默罕默德|-|出席:|一個動詞|過去時態|結構|後|罰的罵|非|一個地方|為它|從|屈折變化，|默罕默德:|活動元素|主格|和標誌|它主格的|damma|表觀|於|它的結束。|2-|旅行|所選|-|旅行:|一個動詞|過去時態|結構|後|罰的罵|非|一個地方|為它|從|屈折變化，|選擇:|活動元素|主格，|和標誌|它主格的|是 damma|應該|後|阿勒夫|防止|從|其明顯|不可能的事。|3-|我們還將赴|法官|-|我們將旅行:|所見|一個粒子|該值指示|後|未來，|他旅行，|一個動詞|現在時態|陳述語氣|為其免費|從|虛擬語氣|與命令，|和標誌|它指示性的|damma|很明顯，|和我們:|代詞|採取行動|在上面|結構|後|蘇坤|於|地方|賓格的|法院和法官:|活動元素|主格，|和標誌|它主格的|damma|應該|後|是啊|防止|從|其明顯|困難。|4-|接受|我的兄弟|-|接受:|一個動詞|過去時態|結構|後|罰的罵|非|一個地方|為它|從|屈折變化，|和哥哥:|活動元素|主格，|和標誌|它主格的|damma|應該|後|它的結局|防止|從|其明顯|函式|一個地方|與母音|適當情況下，|和兄弟|擁有所附，|和嚴|第一人|代詞|連接藏有|到它|結構|後|蘇坤|於|地方|所有格。|問題|對象|ㄧㄣ|活動元素|語言|和術語嗎?|給|為活躍的元素|顯式|兩個例子|和積極的元素|解釋|與顯式|兩個例子|此外，|讓|為活躍的元素|主格|與名詞|動詞的|用兩個例子，|和積極的元素|主格|與名詞|動詞的|用兩個例子，|到|幾個|組件|劃分|積極的元素嗎?|對象|ㄧㄣ|明顯的嗎?|對象|ㄧㄣ|隱藏?|到|幾個|組件|劃分|隱藏?|後|幾個|種類|各不相同|代詞|連接嗎?|對象|ㄧㄣ|代詞|分隔的所分離的嗎?|給|為代詞|分離/拆|效果|活動元素|含有|二|十|範例|品種，|和顯示|什麼|是指|在上面|於|每個|從它。|活用|這句話|給出:|寫入|馬哈茂德|他的課|......|購買|阿裡|一本書|......|(我的百姓啊|回覆|向調用方/召喚師|Allah)(46:31)|。|(無論是誰|行為|理直氣壯地|然後為他的靈魂|)(41:46)。
GreatMasterpiece45=替代|從|活動元素|它說:|(章|外力|其中|沒有|通話|其積極的元素)|和它是:|名詞，|主格，|其中|沒有|提及|與它|其積極的元素。|我說:|當然|ㄧㄣ|這次演講|作者|從|一個動詞|和積極的元素|並採取行動時|有了它，|就像|(切|馬哈茂德|分公司)|就像|(記住|哈利勒|這一課)|就像|(削減|亞伯拉罕 ·|分公司)|RD|(記憶|阿裡|這一課)|和肯定|刪除|演講者/第一人|活動元素的|從|此|語音|和滿意|與提|動詞的|和其行事，|在這種情況下或在這段時間|它是必要|在上面|那|更改|表單|動詞，|和變化|形式|行動上|此外，|持續|更改|圖像|動詞的|然後將給|這次演講|在其上，|和|更改|形式|行動上|然後當然它|之後|那|是|賓格|變得|主格，|並給出了它|這項裁決|活性元素:|從|必要性|延遲|從|動詞，|和女性氣質|動詞的|為它|If|是|女性，|和其他比|那，|和電話|在這種情況下|(替代|活性元素)|或|(的所作所為後|其中|沒有|通話|其積極的元素)。
GreatMasterpiece46=發生的變化|動詞|之後|刪除|活動元素的|它說:|然後如果|是|動詞|過去時態|把 damma|第一; 首先|把 kasra|什麼|之前|其結局/倒數第二|如果|是|現在時態|把 damma|第一; 首先|把罰的罵|什麼|之前|其結局/倒數第二。|我說:|提到|作者|於|這些|標誌|變化|其中|發生|於|動詞|含有|刪除|其積極的元素的|和它的附件|到|採取行動，|和那|它|If|是|動詞|過去時態|提出了 damma|它的第一|並提出了 kasra|這封信|其中|之前|它的結局，|然後你說:|(被切斷|分公司)|RD|(正在背|這一課)|如果|是|動詞|現在時態|提出了 damma|它的第一|並提出了罰的罵|這封信|這就是|之前|它的結局，|然後你說:|(是被削減|分公司)|RD|(是被記住|課)。
GreatMasterpiece47=組件|而代以|積極的元素的|它說:|它是|後|兩個部門:|很明顯，|和隱藏;|然後明顯|就像|你說:|(被毆打/點擊|紮伊德)|RD|(是毆打/點擊|紮伊德)|RD|(榮獲|) Amr|RD|(是榮幸|Amr)。|隱藏|二|十、|就像|你說:|(我是毆打/命中，|和我們被毆打/命中，|和你男性被毆打/命中，|和你女性被毆打/命中，|你們倆毆打/命中，|和你所有男性被毆打/命中，|和你所有女性被毆打/命中，|和他被毆打/命中，|和她被毆打/命中，|兩人毆打/命中，|和他們男性被毆打/命中，|和他們女性被毆打/命中)。|我說:|劃分|替代|活動元素的|-|像什麼|劃分|活動元素|-|到|表觀|和隱藏，|隱藏|到|已連結|和超然。|和類|每個|組件|從|代詞|二|十:|二|揚聲器/第一人稱，|和五|為解決/二人|和五|對於其他/第三次的人，|和肯定|我們提到過|詳細|那|所有的它|於|這一章|活動元素的|然後不|需要|和我們一起|到|重複一遍||演習/練習|後|拐點|活用|兩個句子|給出:|被尊重|這位學者，|被羞辱被輕視|無知的人。|答案/回應|1-|尊重:|一個動詞|現在時態|結構|用於被動語態，|陳述語氣|為其免費|從|虛擬語氣|與命令，|和標誌|它指示性的|damma|很明顯，|學者:|替代|活動元素的|主格|和標誌|它主格的|damma|明顯。|2-|被羞辱看不起:|一個動詞|過去時態|結構|用於被動語態，|結構|後|罰的罵|非|一個地方|為它|從|屈折變化，|無知的人:|替代|對於活躍的元素，|主格|和標誌|它主格的|damma|明顯。|練習/演習|1-|每個|個句子|從|句子|給出了|作者|從|一個動詞|和積極的元素|並採取行動，|然後刪除|活動元素|和使|所作所為後|替代|從它，|和放|動詞|與母音跡象|完成。|剪下|馬哈茂德|一朵花，|購買|我的兄弟|一本書，|讀取|亞伯拉罕 ·|他的課，|給 (慈善)|我的父親|給窮人，|榮譽|老師|工作努力，|學習|我的兒子|扔，|尋求|悔改的人|我們的主。|2-|車廠|每個|名詞|從|名詞|給出了|替代|從|活動元素|於|一個句子|有意義:|醫生，|老虎，|這條河，|大鼠，|這匹馬，|這本書，|這支鋼筆。|3-|車廠|每個|動詞|從|動詞|給出了|用於被動語態，|把它放|與母音的跡象，|把 damma|到它|替代產品|活動元素的|已完成|它的|與它|講話。|他的榮譽|他削減|他的十字架，|他吃了，|他騎|他讀，|他削尖 (鉛筆)。|4-|指定|活動元素|其替代品|和動詞|結構|為主動語態|和結構|用於被動語態，|從|引用|單詞|其中|於|短語|給出:|有沒有|失敗 / 步子|從|一種求善，|和沒有|遺憾|從|一個尋求諮詢，|當|變強|你的兄弟|然後變得軟弱，|他的人|不是|謹慎謹慎|造成的後果|非|他會發現|對他來說|一位朋友，|是|賈法爾|兒子|Yahyaa|說:|稅收|是的支柱|王國統治的|和什麼|一直高舉/尊敬|這樣的例子和|正義，|而不是|微不足道|這樣的例子和|不公正的。|講話|人民|僕人|最仁慈|兒子|接替的|那|輻條|歐麥爾|兒子|哈塔卜|於|那|使平靜/軟/溫柔|對他們來說，|的確如此他|當然|有些害怕|甚至，|他擔心|處女|於|他們的處所，|然後說:|歐麥爾:|真正我|不要|尋找|對他們來說|除了|那，|當然他們|If|知道|他們有什麼|與我，|他們會採取抓起 /|我的服裝|乘 |我的脖子/喉嚨，|非|指責|是誰|照顧/看起來後|自己，|誰|被保護|從吝嗇/貪婪|自己的|將是安全的。|問題|對象|ㄧㄣ|替代|活性元素嗎?|如何可以|你明白|為它|一個名詞|由它的結局嗎?|對象|其中|它的行為|於|動詞|附近的|其附件|替代|一個積極的元素嗎?|對象|其中|沒有它|於|所作所為後|If|保持它|這個地方|活性元素嗎?|車廠|三|範例|改為|活動元素的|明顯。
GreatMasterpiece48=主題|和謂詞|它說:|(章|主題|和謂詞)|主題:|它是|名詞|主格|空閒|從|原因/因素/主動元素|口頭表達 /|和謂詞:|它是|名詞|主格|從屬參照|到它，|就像|你說:|(宰|是站)|RD|(兩個 Zayds|站)|RD|(Zayds|站)。|我說:|主題|標誌|從那|尋找|在它|三|東西，|第一:|那|ㄧㄣ|名詞，|然後免費|從|那|動詞|和粒子，|和第二次:|那|ㄧㄣ|主格，|然後免費|與那|賓格|和所有格|用粒子/介詞|所有格的|來源語言|和第三:|那|ㄧㄣ|空閒|從|因素/原因/主動元素|口頭表達 /|和意義|這|那|ㄧㄣ|空閒|從|因素/原因/主動元素|運算式/口述|製作|動詞|和一個例子|be/(was) 對動詞|和它的姐妹;|然後如果|名詞|出現次數|之後|一個動詞|ㄧㄣ|使用中的元素|或|替代|從|活動元素|後|什麼|以前|解釋說，|名詞|發生|之後|be/(was) 對動詞|或|之一|它的姐妹|被稱為|(名詞|是動詞)|而不是|被稱為|本課題。|和示例|完全|這些|條件|三|(穆罕默德)|從|你說:|(默罕默德|是目前)|然後當然它|是一個名詞|主格|非|它之前|原因/因素/主動元素|語言/發音/口腔。|和謂詞:|它是|名詞|主格|其中|是/連接|到|主題|並同意|在其上，|然後是完整|它的|與它|這次演講|和它的例子|(目前)|從|你說:|(默罕默德|目前)。|和執政的|每個|從|主題|和謂詞|主格|像什麼作為|你看到，|與此|主格|作為為|那|ㄧㄣ|與 damma|很明顯，|就像|(真主|是我們的主)|RD|(默罕默德|是我們的先知)|至於|那|ㄧㄣ|主格|與 damma|應該|為不可能的事|就像|(Moses|是選擇/選擇一|從|安拉)|就像|(蕾拉|是最好的|女孩)|至於|那|ㄧㄣ|與 damma|應該|防止|從|其明顯|困難|就像|(法官|ㄧㄣ|來)。|至於|那|ㄧㄣ|主格|一封信|從|字母|其中|替代品|從|damma|就像|(兩個硬-工人|是成功的)。|肯定|必須很重要|於|主題|和謂詞|那|如下|於|單數|就像|(默罕默德|是站)|和雙|就像|(兩個穆罕默德|站)|和複數|就像|(穆罕默德|站)|中和|男子氣概|像這些|例子，|中和|女性氣質|就像|(後腿|是站)|RD|(兩個不要驚動|站)|RD|(不要驚動|站)。
GreatMasterpiece49=主題|有兩個部分:|表觀|和隱藏|它說:|和主題|有兩個部分:|很明顯，|和隱藏;|然後明顯|什麼|來之前|其一提，|隱藏|二|十、|和他們是:|我，|我們，|你陽剛，|你女性，|你們兩個，|你所有男性，|你所有的女性，|他，|她，|他們兩個，|他們陽剛，|他們女性，|就像|你說:|(I|站)|RD|(我們|站)|和什麼|是類似于|那。|我說:|劃分|主題|into|兩個部分:|第一; 首先|很明顯，|和第二個|隱藏，|和肯定|以前|於|這一章|活動元素的|你理解|每個|從|表觀|和隱藏。|然後示例|主題|表觀|(默罕默德鋸|是的使者|真主)|RD|(RA Aisha|是母親|信徒)|和主題|隱藏|二|十|運算式。|第一:|() i|揚聲器/第一人|一個人，|就像|(I|我的僕人|真主)。|第二種:|(我們)|揚聲器/第一人|多|或|一|製作很重要|自己，|就像|(我們|站)。|第三:|(你陽剛)|為解決/二人|單數|男性，|就像|(你陽剛|理解)。|第四:|(你女性)|為解決/二人|單數|女性，|就像|(你女性|都是聽話)。|第五:|(你們兩個)|兩個處理/二人|男性|是|或|女性，|就像|(你兩個男性|站)|RD|(你兩個女性|站)。|第六:|(你所有男性)|為複數|男性|第二個人，|就像|(你所有男性|站)。|第七:|(你所有女性)|為複數|女性|第二個人，|就像|(你所有女性|站)。|第八:|(他)|為單數|其他/三人|男性，|就像|(他|正在執行|他的職責)。|第九屆:|(她)|為單數|女性|其他/三人，|就像|(她|旅遊)。|第十屆:|(他們兩個)|為雙|其他/三人|不受限制，|男性|是|或|女性|就像|(兩個男性|站)|RD|(兩個女性|站)。|第一; 首先|十:|(他們陽剛)|為複數|男性|其他/三人，|就像|(他們陽剛|站)。|第二個|十|(他們女性)|為複數|女性|其他/三人，|就像|(他們女性|站)。|如果|是|主題|代詞|然後當然它|非|ㄧㄣ|除了|明顯明顯|分離，|諸如此類|你看見。
GreatMasterpiece50=部分|謂詞的|它說:|和謂詞|有兩個部分:|單數;|和其他比|奇異，|然後是單數|就像:|(宰|是站)|和其他比|單數|四|事情:|介詞|和它支配這個詞在所有格形式，|和間接言語名詞，|和動詞|含有|其積極的元素，|和主題|含有|其謂語|就像|你說:|(宰|在其中|房子，|和 Zayd|就在附近/你，|和 Zayd|是站|他的父親，|和 Zayd|他女性的奴隸/阿比蓋爾|去)。|我說:|劃分|謂詞|到|兩個部分:|第一; 首先|謂詞|奇異，|和第二個|謂詞|其他比|奇異。|和的意思|由奇|在這裡:|什麼|不是|一個句子|而不是|准/類似于|句子，|就像|(站)|從|你說:|(默罕默德|是站)。|和其他比|單數|兩種類型:|一個句子|和准|句子。|和這句話|兩種類型:|一個句子|名義上，|和一個句子|口頭。|然後這句話|名義上:|什麼|是由組成/撰寫|從|一門學科|和謂詞|就像|(他的父親|是慷慨)|從|你說:|(默罕默德|他的父親|是慷慨的)。|和這句話|語言:|什麼|是由組成/形成/建造/撰寫|從|動詞|和活動元素|或|其替代物，|就像|(旅行|他的父親)|從|你說:|(默罕默德|旅行|他的父親)|就像|(被擊中|他的兒子)|從|你說:|(哈立德|被擊中|他的兒子)。|因此，如果|是|謂詞|一個句子|然後一定要|為它|從|連接|連接它|這一主題，|作為為|代詞|返回|到|主題|像什麼|你聽說過|於|該示例|至於|名詞|指向示範 /|就像|(默罕默德|此|是一個人|慷慨而定)。|和准|個句子|兩種類型|此外，|第一:|介詞|和它支配這個詞在所有格形式，|就像|(在|這座清真寺)|從|你說:|(阿裡|在其中|這座清真寺)|和第二個:|名詞，|就像|(以上|分公司)|從|你說:|(這只鳥|以上是|分支)。|從|那|你知道的|那|謂詞|是時|詳細資料|五|部件:|奇異，|和一個句子|口頭，|和一個句子|名義上，|和一個介詞|和它所管治的話語在所有格形式，|和名詞。|練習|後|拐點|活用|句子|給出:|默罕默德|站，|默罕默德|出席|他的父親，|默罕默德|他的父親|正在旅行，|默罕默德|在其中|房子，|默罕默德|是的/靠近你。|回應/答案|1-|默罕默德|是站|-|默罕默德:|主旨|主格|與初始，|和標誌|它主格的|damma|於|它的結局，|站:|謂詞|為主題|主格|這一主題，|和標誌|它主格的|damma|表觀|於|它的結束。|2-|默罕默德|出席|他的父親|-|默罕默德:|一門學科，|出席:|一個動詞|過去時態|結構|後|罰的罵|非|一個地方|為它|從|屈折變化，|父親:|使用中的元素|出席，|主格|帶有 waw|更換|從|damma|因為它|是從|名詞|五、|和父親|是附加的所擁有的|和 haa|是擁有/附加|到它，|結構|後|damma|於|地方|所有格，|和這句話|從|動詞|和活動元素|於|地方|主格的|是謂語|問題，|和連接|介於|主題|和謂詞|它是|代詞|發生|擁有/附加|到它|於|你說:|(他的父親)。|3-|默罕默德|他的父親|旅行|-|默罕默德:|一門學科|第一個|主格|與 damma|很明顯，|和父親:|一門學科|第二個|主格|帶有 waw|更換|從|damma|因為它|是從|名詞|五、|和父親|是附加的所擁有的|和 haa|擁有/附加|到它，|旅遊:|謂詞|主題|第二，|和這句話|主題|第二個|RD|其謂語|於|地方|主格的|述詞|主題|第一，|和連接|介於|這句話|和主題|第一個|代詞|其中|在其中|你說:|(他的父親)。|4-|默罕默德|在其中|這房子|-|默罕默德:|一門學科，|在其中|房子:|介詞|和那些它支配/使所有格|相關|與刪除|謂詞的|主題。|5-|默罕默德|是的/靠近你|-|默罕默德:|一門學科，|旁邊:|名詞|地方|相關|與刪除|謂詞的|問題，|和通過或其附近:|附加所擁有，|和 kaf|代詞|每秒處理人|連接藏有|到它|結構|後|罰的罵|於|地方|所有格。|練習/演習|1-|請參閱|主題|和謂語，|和類型|每個|一|從他們，|從|介於|單詞|發生|於|句子|給出，|如果|是|謂詞|這句話的|然後之間|連接|它之間|和之間|本課題。|勤奮的工人|獲取|他的目標，|驅動程式|較強|於|旅行/旅行，|棕櫚樹|生產|它的果實|每|年|有一次，|信徒|榮耀|真主，|你的書|是乾淨的|此|畫筆|是從|木頭，|羊毛|是採取|從|羊，|和發毛皮|從|駱駝，|這雙鞋|都是|從|皮革|山羊的|和其他人或其它比它，|鍋內|位於|火，|尼羅河|灌水的水域|這片土地|埃及的|您|瞭解|這其中|有利於你，|你的父親|那個誰|花|在你身上，|你的母親|是最值得|人|你的順服，|麻雀|唱著|如上|這棵樹，|發亮|如下|雨中，|窮人或貧窮的人|是一個人|剝奪了|他自己|雖然他是|找到，|我的朋友|他的父親|是他，|我的父親|與他有|一匹馬，|我的兄弟|對他來說有|是一輛車。|2-|使用|每個|名詞|從|名詞|給出了|一門學科|於|兩個句子|有意義，|所以|ㄧㄣ|其謂語|於|一|從這兩個|單數|中和|第二|一個句子:|這兩個學生，|默罕默德，|水果，|西瓜，|這支筆，|這本書，|該研究所|尼羅河|阿伊莎，|兩個女孩。|3-|使謂詞|從|每個|名詞|從|名詞|給出了|與准|句子:|麻雀，|絨面，|亞歷山德里亞，|開羅，|這本書，|椅子上，|這條河|尼羅河。|4-|名次|為每個|介詞|和那些它支配/使所有格|用什麼|如下|一門學科|適當的|完成|由它|與它|演講:|於|籠子裡，|附近的|這座山|穆蓋塔姆，|從|木頭，|後|岸/灘|海，|從|羊毛，|於|包裡的東西|於|方向|西部|/|開羅。|5-|建構|三|個句子|於|描述|駱駝的|包含|每個|一|從他們|後|主題|和謂詞。|問題|對象|ㄧㄣ|會議的議題?|對象|ㄧㄣ|謂語?|進入|幾個|組件|劃分|會議的議題?|車廠|為主題|很明顯，|成為|為主題|隱藏，|into|幾個|組件|劃分|隱藏|其中|位於|會議的議題?|進入|幾個|組件|劃分|謂詞|句子嗎?|進入|幾個|組件|劃分|謂詞|准|句子，|什麼|其中|連接|謂詞|這句話的|與主題?|內|其中|事|答案|符合|謂詞|為主題嗎?|車廠|為每個|型別|從|類型|謂詞的|兩個例子。
GreatMasterpiece51=取消/annuller|主題|和謂詞|它說:|(章|功能/元素/致使概念|進入|後|主題|和謂詞)|和他們是|三|事情:|動詞是|和它的姐妹，|和賓格粒子當然可以|和它的姐妹，|我想|和它的姐妹。|我說:|當然|你知道的|那|主題|和謂詞|兩個主格例。|知道|它|當然|進入|在這兩個|一|因素/積極的元素|表達/口述|然後更改|其兩個的屈折變化，|和這些|因素|其中|輸入|在這兩個|更改|其拐點|-|之後|追蹤|這次演講|阿拉伯人的|值得信賴可靠|與 it(investigation/exploration)|-|後|三|部件:|第部分|第一:|它使主格|主題|和使賓格|謂詞，|這是|be/(was) 對動詞|和它的姐妹，|與此|組件|他們每個人都|是動詞，|就像|(是|天氣|清除)。|第部分|第二:|它使賓格|主題|和使主格|謂詞，|相反|第一，|和那|賓格 particle/(certainly)|和它的姐妹|和那|第部分|喜歡它|顆粒，|就像|(實在|真主|是最強大|大多數的 Wise)(2:220)。|第部分|第三:|它使賓格|主題|和謂詞|在一起，|和那|(我以為)|和它的姐妹/親戚，|與此|組件|喜歡它|動詞，|就像|(我以為|朋友|是的哥哥)。|並要求|這些|元件|(對消器/annuller);|因為他們|廢除/取消|這項裁決|主題|和謂語，|其中:|它更改/更新它們|發現|對他們來說|裁決|另一個|其他比|他們兩個的裁決|第一次。
GreatMasterpiece52=動詞是|和它的姐妹|它說:|然後為|be/(was) 對動詞|和它的姐妹，|然後當然它|使得主格|名詞，|和使賓格|謂詞，|和他們是:|動詞是，|和它在夜晚，成為了|和它變成 / 早晨，成為|和它在那天上午，成為了|和他保持的所成為的|和它在夜晚成為了/他花留夜/一夜之間，|它變成了，|而不是|還有 (繼續)|他是|並不是保持|他是停止某事，|和不/不斷|他是停止某事，|和仍然/繼續|他是|而且只要|他剩餘，|和什麼|推匯出|從他們|就像:|他是，|他是|和，|和他成為了/它成為了早晨，|和他成為/它變得早晨，|成為 (上午)|你說:|(是|宰|站，|並不是|Amr|凝視著/看了一眼眼中)|和什麼|是類似|到那。|我說:|第部分|第一個|從|取消/廢止|主題|和謂詞|be/(was) 對動詞|和它的姐妹，|其中:|類似/等於它|於|功能。|與此|組件|進入|後|主題|所以它刪除|它主格|第一次 (原因)|並給出了|為它|主格|新 (原因)，|和電話|主題|其名詞，|進入|後|謂詞|然後使賓格|和電話|其謂詞。|與此|組件|三|十|動詞:|第一:|(是) / 動詞是|和它|是指|描述|名詞的|與謂詞|於|過去時態，|持續|含有|停用結論|就像|(是|默罕默德|一個勤勞的工人)|持續|含有|連續性/連續性，|就像|(和是|你的主|所有的 powerful)(25:54)。|和第二個:|(它成為了在晚上)|和它|是指|描述|名詞的|與謂詞|於|晚上，|就像|(成為在晚上|天氣|冷)。|和第三個:|(早晨成為了)|和它|是指|描述|名詞的|與謂詞|於|早晨，|就像|(早晨成為了|天氣|多雲/陰)。|和第四個:|(在午前成為了)|和它|是指|描述|名詞的|與謂詞|於|那天上午，|就像|(在午前成為了|學生|處於活動狀態)。|和第五個:|(他仍然成為/變更)|和它|是指|描述|名詞的|與謂詞|於|整個|白天，|就像|(變得|他的臉|darkened)(43:17)。|而第六:|(他花了晚上/呆一夜)|和它|是指|描述|名詞的|與謂詞|於|夜晚的時間|就像|(支出夜/住一夜|默罕默德|快樂)。|和第七個:|(它改變了)|和它|是指|變化|名詞的|從|其條件|到|狀態|其中|ㄧㄣ|在上面|謂詞，|就像|(成為了|粘土|一壺)。|和第八:|(它不是)|和它|是指|否定|謂詞的|從|名詞|於|時間|目前，|就像|(不是|默罕默德|理解)。|第九次|和第十屆|和第一次|後十|和第二個|後十:|(和仍然 (繼續)|他是)|RD|(並不保持|他是停止某事)|RD|(和不/不斷|他是停止某事)|RD|(和仍然/繼續|他是)，|和這些|四|參照|後|以下|謂詞的|該名詞|根據|要求|條件下，|就像|(仍未|接受/申明|亞伯拉罕 ·|邪惡)|就像|(還不|停止/不再|阿裡|一位朋友|真誠)。|第三個|後十|(只要|他是)|和它|是指|以下|謂詞的|該名詞|還|就像|(不|我責怪|哈立德|只要|我是|活著)。|並且劃分|這些|動詞|-|從|側/關於|行動/函數|-|到|三|部件:|第部分|第一:|什麼|讓|此|動作|-|它是|主格|名詞的|和賓|謂詞的|-|與條件|正在啟動|(只要)|動詞不定式|副詞|在上面|它是|一個動詞|一|它是|(他剩餘)。|第部分|第二:|什麼|讓|此|動作|與條件|那|到職|在上面|否定，|或|質疑，|或|禁止，|和他們是|四|動詞，|和他們是:|(他是)|RD|(他是停止某事)|RD|(他是停止某事)|RD|(他是)。|第部分|第三:|什麼|讓|此|動作|沒有|條件，|和他們是|八|動詞，|和他們是|剩下。|並且劃分|這些|動詞|從|狀態|變化|into|三|部件:|第一; 首先|部分:|這其中|推匯出|於|動詞|拐點|完成，|與意義|它|來自|從它|過去時態|和現在時態|和命令緊張，|它是|七|動詞，|和他們是:|動詞是，|和它在夜晚，成為了|和它變成 / 早晨，成為|和它在那天上午，成為了|和他保持的所成為的|和它在夜晚成為了/他花留夜/一夜之間，|和它變成。|和部分|第二:|這其中|推匯出|於|動詞|拐點|不完整，|與意義|它|來自|從它|過去時態|和現在時態|非|其他，|它是|四|動詞，|和他們是:|他是|和他是停止某事，|和他是停止某事，|和他是。|第部分|第三:|這其中|非|反映|來源語言|它是|兩個動詞:|兩個之一|(不是)|由協定|和第二個|(他剩餘)|後|最正確。|和其他|過去時態|從|這些|動詞|執行|功能|過去式，|就像|你說:|最高:|(而不是|他們停止|differing)(11:118)，|(永遠不會|我們將停止|在上面|被 devoted)(20:91)，|(由真主|你不會停止|記住|Joseph)(12:85)。
GreatMasterpiece53=當然跟賓格助詞|和它的姐妹|它說:|和|當然賓/粒子|和它的姐妹|然後當然它|讓賓格|名詞|和使主格|謂詞，|和他們是:|當然/的確/實在，|而且，|但是，|好像，|希望 / 如果只，|也許，|你說:|實在|紮伊德|站，|我希望|Amr|被盯著看的所凝視的|和什麼|類似|到它，|和意義|肯定|和那|強調，|但|為校正/整改/對供應的是缺掉的|因為如果|相比之下，|和想要是|祝福，|也許|希望|和期望。|我說:|第部分|第二個|從|取消/廢止|主題|和謂詞|(實在) / 賓格粒子|和它的姐妹，|其中:|類似/等於它|於|功能，|和它|進入|後|主題|和謂語，|然後使賓格|主題|和電話|其名詞，|和使主格|謂詞|-|與意義|它|更新|為它|nominativeness|其他比|其中|是|為它|之前|它的條目|-|和電話|其謂語|和這些|文書|他們每個人|顆粒，|和他們是|六:|第一; 首先|(當然/實在/真實地)|與 kasra|哈姆紮。|和第二個|(，)|與罰的罵|哈姆紮。|和他們兩個|參照|後|強調，|及其意義|加強|關係/歸因|謂詞的|到問題時，|就像|(肯定|你的父親|參加)，|就像|(我知道|那|你的父親|旅遊)。|第三個|(但是)|及其意義|校正|它是|繼承|字|與否定|其中|被視為|其確認|或|確認|其中|被視為|它的否定，|就像|(默罕默德|是勇敢|但|他的朋友|是懦夫/膽小者)。|第四|(好像)|和它|是指|後|比較|主題|與謂詞，|就像:|(這是因為如果 / 看起來像|那個女孩|一輪滿月)。|第五個|(希望要是)|及其意義|許願，|和它是:|要求|不可能|或|什麼|在它|困難，|(我希望|青年|可以返回)|就像|(我希望|愚蠢的白癡/人|要通過)。|第六|(也許)|和它|是指|後|希望|或|由於擔心及期望，|和意義|希望:|請求|一件事...|喜歡，|而不是|ㄧㄣ|除了|於|可能性|就像:|(也許|真主|將憐憫我)|和意義|擔心/期待:|期待|發生|一件事|不喜歡|於|本身，|就像:|(也許|敵人|是密切|給我們)。
GreatMasterpiece54=他思想雙賓動詞|和它的姐妹|它說:|和|我思想雙賓動詞|和它的姐妹|然後當然它|讓賓格|主題|和謂詞|後|那兩個|採取行動|對他們來說，|和他們是:|我思想/相信/認為，|和我思想/相信/認為，|和我思想/相信/認為，|和我思想/相信/認為，|我知道，|我知道，|而我發現，|和我了，|和我做了，|並聽取了;|你說:|我以為|宰|站起來了，|我看見|Amr|凝視所看，|和什麼|是類似|到那。|我說:|第部分|第三個|從|對消器/annuller|主題|和謂語，|(我以為)|和它的姐妹|其中|類似/等於|於|功能，|和他們|輸入|後|主題|和謂詞|然後使二者賓格|在一起，|它是說|為主題|採取行動|第一個|和謂詞|採取行動|第二，|與此|組件|十|動詞:|第一; 首先|(我以為)|就像|(我以為|默罕默德|是朋友)。|和第二個|(我以為)|就像|(I 思想/認為/相信|把財富|是有用有益)。|第三個|(我以為)|就像|(I 思想/認為/相信/聲稱|花園裡|是富有成果)。|第四|(我以為)|就像|(我以為|巴克爾|是勇敢)。|第五個|(我知道)|就像|(我知道/認為/相信/思想|亞伯拉罕 ·|是成功的)。|第六|(我知道)|就像|(我知道|朋友|搶救)。|第七個|(我發現)|就像|(我發現|義|是那扇門|善良)。|和第八|(花了)|就像|(我用了|默罕默德|作為一個朋友)。|第九次|(我做了)|就像|(我做了|黃金|成圈)。|和第十屆|(聽說)|就像|(我聽說|哈利勒|閱讀)。|這些|動詞|十|除|到|四|部件:|第部分|第一:|它是指|概率|發生|謂詞的|它是|四|動詞，|和他們是:|我思想/相信/認為，|和我思想/相信/認為，|和我思想/相信/認為，|和我思想/相信/認為。|和部分|第二:|它是指|定罪適|和確認|發生|謂詞的|它是|三|動詞，|和他們是:|我知道，|我知道，|而且我發現。|和部分|第三:|它是指|移交|和移動，|它是|兩個動詞，|和這兩個是:|我花了，|和我做了。|和部分|第四:|它是指|有關/歸因|於|聽證會上，|它是|一個動詞|一個人，|它是|聽到了。|練習/演習|1-|Enter|動詞是 /(was)|或|一|它的姐妹|後|每個|個句子|從|句子|給出了|然後|放|結局|每個|word|與母音的跡象。|天氣|是陽光明媚萬里無雲。|衛兵/看守員|是清醒的。|空氣|是新鮮的。|花園裡|是卓有成效的。|園丁|是醒/警報/小心。|讀取|是有用的。|真相|是有益的。|天課/慈善機構|是強制性/強制/必不可少。|太陽|太熱了。|寒冷|是嚴重激烈。|2-|Enter|(實在) / 賓格粒子|或|一|它的姐妹|後|每個|個句子|從|句子|給出，|然後|放|與母音跡象|結束|每個|詞:|我的父親|將要參加會議，|你的書|是新的|你的墨水瓶|很髒，|你的鋼筆|壞了，|你的手|是乾淨的|這本書|是一個很好|朋友，|人品的舉止|是值得稱讚的|蜜瓜/西瓜|將出現|於|夏天，|橙色|屬於|水果|冬天，|棉花|是的原因|為財富|埃及的|尼羅河|是新鮮/愉快|水，|埃及|它的土壤|是好|農業/生長。|3-|Enter|(他認為) / 雙賓動詞|或|一|它的姐妹|後|每個|個句子|從|句子|給出，|然後|放|與母音跡象|結局|每個|詞:|默罕默德|是你的朋友，|你的父親|是最受喜愛|人的人|給你，|你的母親|是最富有同情心的/仁慈|人的人|與你，|欄位|是盛開的所興起的|花園裡|是卓有成效的|今年夏天|灼熱，|朋友|是你的幫手|含有|困難和難度，|沉默|好/漂亮，|服裝|白色|是的衣服|整個夏季，|滑倒/跌跌撞撞|舌頭的|更糟糕的是|比從|滑倒/跌跌撞撞/跳閘|腳。|4-|付諸表決|於|這個地方|空閒|從|每個|示例|從|例子|給出了|一個字|適當情況下，|並將其放置|與母音符號:|(仲裁)|肯定|警衛隊/看守員|......|() b|變得|天課/慈善機構|......|() c|在午前成為了|太陽|......|() d|我知道|朋友|......|() e|肯定|滑倒/跌跌撞撞|舌頭的|......|() f|我知道|那|這本書|......|() g|默罕默德|是我的朋友|但|他的弟弟|......|() h|我知道|你的父親|......|() i|在這一天成為了|天氣|......|() j|看起來像|欄位|......|() k|我知道|你的叔叔|......|() l|我以為|那|棉花|......|() m|在晚上成為了|空氣|......|() n|我聽說過|你的兄弟|......|() o|仍|記得|亞伯拉罕 ·|......|() p|我會和你交朋友|還是一樣|你是|......|() r|好|語音|是從|標誌|成功的|但|沉默|......|5-|名次|檢測|從|文書|取消/撤銷判決的|讓賓格|這個地方|於|每個|地方|空閒|從|例子|給出:|(仲裁)|......|這本書|是一個很好|娛樂/藝人。|() b|......|天氣|沉重|雲豹/陰。|() c|......|真實性|以求安全。|() d|......|你的兄弟|是真實的|對我來說。|() e|......|你的兄弟|我的同學|於|學校。|() f|......|警衛隊/看守員|清醒。|() g|......|老師|一個指南。|() h|......|天堂|謊言背後|雙腳|你的母親。|() i|......|女兒|一所學校。|() j|......|這本書|我娛樂/每晚的同伴。|() k|......|朋友|你的説明|於|困難和難度。|6-|付諸表決|於|地方|空閒|從|每個|示例|從|例子|給出了|一個名詞|並將其放置|與母音跡象|完成:|(仲裁)|是|......|全能者/無所不能。|() b|過夜|......|不通道的人。|() c|我看見|......|在黑暗/烏雲密佈的天空。|() d|我知道|那|公平/公正|......|() e|變得|......|麵包|......|() f|不是|......|脫下衣服/被剝奪/剝去。|() g|在晚上成為了|......|快樂。|() h|當然|......|盛開的明亮。|() i|但願|......|是/出現上升的。|() j|看起來像|......|老師。|() k|非|在停止為|......|我的朋友。|() l|實在|......|是強制性的。|7-|車廠|三|個句子|於|描述|這本書的|每個|一|包括|後|一門學科|和一個謂語|然後|輸入|後|每個|個句子|從它|(是)|和地方|它的詞|與母音的跡象。|8-|車廠|三|個句子|於|描述|下著雨|每個|一|包括|後|一門學科|和一個謂語|然後|輸入|後|每個|個句子|從它|(肯定)|和地方|它的詞|與母音的跡象。|9-|車廠|三|個句子|於|描述|這條河的|每個|一|包括|後|一門學科|和一個謂語|然後|輸入|後|每個|個句子|從它|(我知道)|和地方|它的詞|與母音的跡象。|練習/演習|後|拐點|活用|句子|給出:|事實上|亞伯拉罕 ·|是|nation(16:120)|相似|月亮|一盞燈，|我認為思想 /|貨幣|正如有用/有益，|仍然不|停止|這本書|我的朋友/同伴。|對答案|1-|事實上:|一個粒子|重點|和賓格|讓賓格|名詞|和使主格|謂詞，|和亞伯拉罕:|名詞|的確賓/粒子|賓格|通過它，|和標誌|其賓格的|罰的罵|很明顯，|是:|一個動詞|過去時態|不完整，|使得主格|名詞|和使賓格|謂詞，|和它的名詞|代詞|隱藏|在它|允許|其所謂|ㄧㄣ|返回|後|亞伯拉罕，|國家:|謂詞|是動詞是|賓格|通過它，|和標誌|其賓格的|罰的罵|很明顯，|和這句話|從|是動詞是|和它的名詞|和謂語|於|地方|主格的|述詞|(事實上賓/粒子)。|2-|就好像:|一個粒子|相似的|和賓格|讓賓格|名詞|和使主格|謂詞，|和月亮:|名詞|仿佛 / 賓格粒子|賓格|通過它，|和標誌|其賓格的|罰的罵|很明顯，|和一盞燈:|謂詞|仿佛 / 賓格粒子|主格|通過它，|和標誌|它主格的|damma|明顯。|3-|想法|一個動詞|過去時態|結構|後|罰的罵|應該|後|它的結局|防止|從|其明顯|運作|這個地方|與蘇坤|相反|為排斥|不喜歡|分別|四|vowelled 字母|在什麼|ㄧㄣ|像這個詞|一個人，|及 taa|代詞|一位發言者的/第一人|活動元素|思想/雙賓動詞，|結構|後|damma|於|地方|主格的|財富:|謂詞|第一個|思想/雙賓動詞|賓格|通過它，|和標誌|其賓格的|罰的罵|很明顯，|和有用有益:|謂詞|第二個|思想/雙賓動詞|賓格|通過它，|和標誌|其賓格的|罰的罵|明顯。|4-|不是:|一個粒子|否定之否定|結構|後|蘇坤|非|一個地方|為它|從|屈折變化，|仍停止:|一個動詞|過去時態|未完成|使得主格|名詞|和使賓格|謂詞，|這本書:|名詞|仍停止|主格|通過它，|和標誌|它主格的|damma|表觀|於|它的結局，|朋友/伴侶:|謂詞|仍停止|賓格|通過它，|和標誌|其賓格的|罰的罵|應該|於|它的結局|防止|從|其明顯|函式|這個地方|與母音跡象|適當的|對呀|演講者/第一人稱，|和朋友/伴侶|擁有/附加|和嚴|一位發言者的/第一人|擁有|已連結|到它|結構|後|蘇坤|於|地方|所有格。|問題|後|組件|取消/撤銷判決的|幾個|組件|劃分|取消/廢止嗎?|對象|其中|行為|是動詞是|和它的姐妹嗎?|進入|幾個|組件|劃分|這對姐妹的|(是) / 動詞是|從|側面|功能嗎?|成|幾個|組件|劃分|從|側面|拐點?|對象|其中|行為|(當然) / 賓格粒子|和它的姐妹嗎?|對象|其中|是指|在上面|就好像|和希望?|對象|意思是|校正嗎?|對象|意思是|希望嗎?|對象|意思是|擔心及期望?|對象|其中|行為|(我思想/雙賓動詞|和它的姐妹) 嗎?|進入|幾個|組件|劃分|這對姐妹的|(我思想/雙賓格助詞) 嗎?|給|三|個句子|組成|從|一門學科|和一個謂語|所以|ㄧㄣ|第一; 首先|從|一門學科|很明顯，|和謂詞|句子|口頭，|和第二個|從|一門學科|代詞的|為複數|男性|和謂詞|奇異，|第三個|從|一門學科|表觀|和句子|名義上，|然後|輸入|後|每個|一|從|這些|個句子|(是)|RD|(也許)|RD|(我認為)。|活用|句子|給出:|(和花了|真主|亞伯拉罕 ·|作為親密的 friend)(4:125)|(我希望的 O|我死了|之前|this)(19:23)|(可能會|可及範圍|ways)(40:36)。
GreatMasterpiece55=形容詞|它說:|(章|形容詞)|形容詞:|一個追隨者|被描述的詞|於|它主格|和其賓格|和它的所有格，|和確定性|和不確定性;|站在|宰|智慧，|我看見|宰|智慧，|和我通過|由紮伊|智慧化。|我說:|描述性的名詞/屬性|於|語言的意義|它是|形容詞，|中和|術語|語法意義|它是:|從動件|衍生品的|或|什麼被解釋|作為衍生工具，|澄清|以下|於|確定性，|指定|為它|於|不是確定性。|形容詞和|劃分|到|兩個部分:|第一:|形容詞|真實，|和第二個:|形容詞|證明/激勵/偶爾。|對於|形容詞|True|然後是:|這其中|由主格|代名詞|隱藏|返回|到|被描述的詞|就像|(來了|默罕默德|有頭腦的/智慧)|然後頭腦/聰明:|形容詞|穆罕默德的|它是|製作主格|為代詞|隱藏|其隱含|它是|返回|到|默罕默德。|和|形容詞|偶爾|然後是:|這其中|由主格|名詞|表觀|已連結|用代詞|返回|到|被描述的詞|就像|(來了|默罕默德|良性|他的父親)|然後良性:|形容詞|穆罕默德的|和他的父親:|活動元素|為良性，|主格|帶有 waw|更換|從|damma|因為它|是從|名詞|五、|它是|附加/擁有|到|haa|其中|ㄧㄣ|代詞|返回|到|默罕默德。|和執政的|形容詞的|它|如下|它描述了這個詞|於|屈折變化，|中和|確定性|或|不是確定性，|是否|是|True|或|偶爾。|和意義|此|它|If|是|被描述的詞|主格|是|形容詞|主格，|就像:|(出席|默罕默德|傑出的/義人)|或|(出席|默罕默德|優秀的義人 /|他的父親)|如果|是|被描述的詞|賓格|是|形容詞|賓格|就像:|(我見過|默罕默德|傑出的/義人)|或|(我見過|默罕默德|優秀的義人 /|他的父親)|如果|是|被描述的詞|所有格|是|形容詞|所有格，|就像:|(我看|走向|默罕默德|傑出的/義人)|或|(我看|走向|默罕默德|優秀的義人 /|他的父親)|如果|是|被描述的詞|正定|是|形容詞|明確，|像什麼|於|群組|例子|以前，|如果|是|被描述的詞|無限期|是|形容詞|無限期，|就像:|(我見過|一個男人|智慧/wise)|或|(我見過|一個男人|智慧/智慧|他的父親)。|接著|If|是|形容詞|True|增加|後|那|它|如下|被描述的詞|於|其男子氣概|或|其女性氣質，|中和|其 singularness|或|其對偶性|或|其多元化。|和意義|那|它|If|是|被描述的詞|男性|是|形容詞|男性，|就像|(我見過|默罕默德|智慧/wise)|如果|是|被描述的詞|女性|是|形容詞|女性|就像:|(我見過|法蒂瑪|有禮貌)|如果|是|被描述的詞|單數|是|形容詞|單數|像什麼|你看見|於|這兩個|例子，|如果|是|被描述的詞|雙|是|形容詞|雙，|就像:|(我見過|兩個穆罕默德|智慧/wise)|如果|是|被描述的詞|複數|是|形容詞|複數，|就像:|(我見過|男子|智慧)。|對於|形容詞|偶爾|然後當然它|ㄧㄣ|單數|permanent|如果|是|它被描述的詞|雙|或|複數|你說:|(我見過|這兩個男孩|智慧化|兩個父親)|和你說:|(我見過|男孩子們|智慧化|他們的父親)|和如下|形容詞|偶爾|什麼|在它之後是|於|男子氣概|或|女性，|你說:|(我見過|女兒|智慧化|他們的父親)，|和你說:|(我見過|男孩子們|智慧化|他們的母親)。|然後指定|從|此|解釋/澄清|那|形容詞|True|如下|它被描述的詞|於|四|從|十。|一|從|單數|和雙|和複數，|和一個人|從|主格|和賓|和所有格，|和一個人|從|男子氣概|和女人味，|和一個人|從|確定性|和不確定性。|形容詞和|偶爾|如下|它被描述的詞|於|二|從|五:|一|從|主格|和賓|和所有格，|和一個人|從|確定性|和不確定性，|和如下|它主格|其中|在它之後是|於|一|從|二|兩個是|男子氣概|和女人味，|而不是|如下|任何檔案|於|singularness|和對偶|與多元化、|當然|ㄧㄣ|單數|永久|一直到永遠，|和阿拉|知道。
GreatMasterpiece56=確定性|和它的零件|它說:|確定性|五|事情:|名詞|隱含的代名詞形式|就像:|I|和你，|和名詞|正確|就像:|宰|和麥加，|和名詞|模糊/不清楚/示範|就像:|這個男性|和這個女性|而這些，|和名詞|其中|在它|阿利夫|和林|就像:|男子|和那個男孩，|和什麼|附加|到|一|從|這些|四。|我說:|知道|那|名詞|劃分|into|兩個部分，|第一:|無限期。|它會來。|和第二個:|確定|和它是:|運算式|其中|是指|後|具體/已知的東西，|和它的零件|有五項:|第部分|第一:|暗示 pronounal 表單|或|代詞，|它是|什麼|是指|後|一位發言者/第一人稱，|就像:|我，|或|每秒處理人|就像:|你陽剛，|或|另一個/缺席/離開三分之一人|就像:|他，|和從|這裡|你知道的|那|代詞|是三個|種。|那種|第一:|這其中|使用|以指示|到|演講者/第一人|它是|兩個字，|和這兩個是:|() i|揚聲器/第一人|獨自一人，|RD|(我們)|揚聲器/第一人|小菊|他自己|或|與他|除了他的是。|和那種|第二:|這其中|使用|以指示|後|每秒處理人|它是|五|運算式，|和他們是:|(你陽剛)|與罰的罵|tah 的|為解決/二人|男性|奇異，|RD|(你女性)|與卡斯裡|tah 的|為解決/二人|女性|單數|RD|(你們兩個)|為解決/二人|雙|男性|是|或|女性|RD|(你所有男性)|為複數|男性|每秒處理的人，|RD|(你所有女性)|為複數|女性|每秒處理的人。|和那種|第三:|這其中|使用|以指示|後|其他/三人，|它是|五|運算式|此外，|和他們是:|(他)|其他/三人|男性|奇異。|和|(她)|其他/三人|女性|奇異，|RD|(二)|為雙|其他/三人|不受限制，|男性|是|或|女性，|RD|(他們陽剛)|為複數形式|男性|其他/三人，|RD|(他們女性)|為複數形式|女性|其他/第三人。|以前|此|解釋|於|這項研究|活動元素的|中和|這項研究|主題|和謂詞。|第部分|第二個|從|明確:|正確，|它是|什麼|是指|到|具體的東西|沒有|需要 / 要求|持續|連接|對一位發言者/第一人|或|每秒處理人|或|其他比兩個，|它是|兩種:|男性|就像|(穆罕默德)|RD|(亞伯拉罕)|RD|(裝載)|和女性|就像|(法蒂瑪)|RD|(贊)|RD|(麥加)。|第部分|第三:|名詞|目前還不清楚/含糊不清，|它是|兩種:|名詞|示範，|和名詞|相對的 pronounal 形式。|對於|名詞|示範:|然後是:|這其中|使用|用於引用|後|具體/明確的東西|通過手段|信號/顯示|感官|或|抽象的意義，|和為它|運算式|特定物體|和它是:|(此男性)|對於男性|奇異，|RD|(這是女性)|為單數|女性，|RD|(這些兩個男性)|或|(這些兩個男性)|為雙|男性，|RD|(這兩個女性)|或|(這兩個女性)|為雙|女性，|RD|(這些)|為複數形式|不受限制。|和|名詞|相對|然後是:|這其中|是指|後|具體/明確的東西|通過手段|句子|或|類似于它。|它被提到|在它以後|肯定|它被稱為|關係從句合成關係，|它是|追蹤|後|代詞|匹配|相對|它被稱為|返回/歸屬，|和為它|運算式|特定|此外，|和他們是:|(男性一個誰)|為單數|男性。|和|(女性一個誰)|為單數|女性，|RD|(兩個男性誰)|或|(兩個男性誰)|為雙|男性，|RD|(女性兩人的)|或|(女性兩人的)|為雙|女性，|RD|(那些男性誰)|為複數|男性|RD|(那些女性誰)|為複數|女性。|第部分|第四:|裝飾/開始|alef|和林|和它是:|每個|名詞|連接的|與它|()|那麼它將使我們|明確;|就像|(人，|和這本書，|和那個男孩，|和女孩)。|和部分|第五:|名詞|其中|附加|到|一|從|四|上一步|所以它就有了|確定性|從|附加/擁有|到它，|就像|(你的男孩)|RD|(男孩|默罕默德)|RD|(男孩|這|人)|RD|(男孩|那個誰|我們參觀了|昨天)|RD|(男孩|老師)。|最明確|這些|界定|之後|運算式|陛下:|代詞|然後|專有名詞，|然後|名詞|指向/論證、|然後|名詞|相對，|然後|放置從開始|與確定性文章|然後|附加/擁有|到它。|和附加/擁有|於|同一級別|附加/藏|到它，|除了|附加/擁有|到|代詞|然後當然是|於|同一級別|專有名詞，|和阿拉|最瞭解情況。
GreatMasterpiece57=不確定|它說:|和不確定:|每|名詞|一般/常用|於|其性別|非|指定|與它|一|沒有|其他，|和其密切的理解:|全部|那|使用|條目|alef 的|和林|在其上，|就像|男子|和那匹馬。|我說:|無限期|它是|每個|名詞|已使用|非|用於指定|一|與其他比本身|從|其中|單數|其將性別，|而是|比做正確|其泛化|後|每個|一|後|方式|替換，|就像|(一個人)|RD|(女);|然後如果|第一; 首先|讓正確|其泛化|後|一位男性|成人/全年齡/成熟|從|兒子/部落|亞當的|和第二個|讓正確|其泛化|後|每個|女人|成人/全年齡/成熟|從|兒子/部落|亞當。|和標誌|不確定|那|它是正確|因其|進入|在上面|(明確的粒子)|製作的影響|在它|確定|就像|(一個人)|然後當然它|讓正確|進入|(明確的粒子)|在其上，|製作的影響|在它|明確;|然後你說:|(人)|和像這樣:|一個男孩，|和一個女孩，|和一個男孩，|和一個女孩，|和一位科學家，|那麼肯定你|你說:|那個男孩，|和那個女孩，|和那個男孩，|和那個女孩，|和科學家。|練習/演習|1-|名次|每個|名詞|從|名詞|給出了|於|三|個句子|有意義，|所以|ㄧㄣ|主格|於|一個人，|和賓格|於|第二，|和所有格|於|第三，|和描述|那|名詞|於|每個|個句子|與形容詞|True|適當:|兩名男子。|默罕默德。|麻雀。|老師。|一個女孩。|一朵花。|穆斯林。|你的父親。|2-|名次|形容詞|適當的|於|每個|地方|從|地方|空閒|於|例子|給出，|和地方|與母音符號:|(仲裁)|學生|......|愛他|他的老師|() b|那個女孩|......|高興|她的父母|() c|尼羅河|......|化肥|這片土地|() d|I|愛|這本書|......|() e|我的國家|是埃及|......|() f|學生|......|服務|他們的國家|() g|花園|......|散步步行 /|() h|我見過|一個男人|......|所以我給了慈善機構/花|在他|() i|我住|於|一座房子|......|() j|如何|優秀/良好|房間|......|() k|通過與|我的兄弟|甘蔗/棒|......|() l|我給作為禮物|到|我的兄弟|一本書|......|() m|服裝|......|服裝|夏天的|3-|名次|被描述的詞|適當的|於|每個|地方|從|地方|給出，|和地方|與母音符號:|(仲裁)|......|努力工作|愛他|他的老師|() b|......|知識淵博|服務|他們的國家|() c|I|愛好|......|有用|() d|......|值得信賴|通過與|一通|輝煌|() e|......|濃|連根拔起|樹木|() f|我拿起|......|綻放|() g|我看見|......|差|所以我給了慈善機構/花|關於她|() h|......|嚴重|非|是上承受得住|身體|() i|......|勤奮|服務|法律/伊斯蘭教法|伊斯蘭|() j|我受益|從|影響|......|以前早|() k|......|心愛|是我的本國|4-|尋找|被描述的詞|適當的|為每個|從|形容詞|給出，|然後|使用|形容詞|和被描述的詞|一起|於|一個句子|有意義，|和地方|兩個他們的結局|與母音符號:|巨大，|有禮貌，|高，|甜美新鮮|春暖花開，|聰明，|遠，|慷慨，|誠實，|聰明，|有禮貌，|寬，|寬。|練習/演習|後|拐點|活用|句子|給出:|這本書|是一個伴侶|令人愉快/令人愉快，|學生|努力工作|喜歡他|他的老師，|女孩子們|有禮貌|服務|他們的國家，|我喝了|從|水|鮮甜。|回應/答案|1-|這本書:|一門學科|主格|通過在開始，|和標誌|它主格的|damma|表觀|於|它的結局，|伴侶:|述詞|問題，|主格|通過在開始，|和標誌|它主格的|damma|表觀|於|它的結局，|令人愉快/令人愉快:|形容詞|為伴，|形容詞和|主格的|是主格，|和標誌|它主格的|damma|表觀|於|它的結束。|2-|學生:|一門學科|主格|通過在開始，|和標誌|它主格的|damma|表觀|於|它的結局，|努力工作:|形容詞|對於學生來說，|形容詞和|主格的|是主格，|和標誌|它主格的|damma|表觀|於|它的結局，|喜歡:|一個動詞|現在時態|陳述語氣|為其免費|從|虛擬語氣|與命令，|和標誌|它指示性的|damma|表觀|於|它的結局，|和 haa:|代詞|其他/第三人稱的|採取行動|通過它，|結構|後|damma|於|地方|賓格的|老師:|使用中的元素|喜歡|主格，|和標誌|它主格的|damma|表觀|於|它的結局，|和老師|附加所擁有，|和 haa|代名詞|其他/第三人稱的|擁有/附加|到它，|結構|後|damma|於|地方|所有格，|和這句話|從|動詞|和其積極的元素|於|地方|主格的|述詞|主題|其中|ㄧㄣ|學生，|和連接|介於|主題|和這句話|謂詞的|ㄧㄣ|代詞|賓格|於|(喜歡他)。|3-|女孩:|一門學科|主格|通過在開始，|和標誌|它主格的|damma|很明顯，|和有禮貌:|形容詞|女孩子們，|形容詞和|主格的|是主格，|和標誌|它主格的|damma|很明顯，|服務:|一個動詞|現在時態|結構|後|蘇坤|連接|中午與|女性的特質，|到中午|女性氣質|是活躍的元素，|結構|後|罰的罵|於|地方|主格的|國家:|採取行動|由它|為服務|賓格|和標誌|其賓格的|罰的罵|很明顯，|和國家|附加所擁有，|和他們:|代名詞|複數|女性氣質|其他/三人|連接藏有|到它，|結構|後|罰的罵|於|地方|所有格，|和這句話|從|動詞|和活動元素|於|地方|主格的|謂詞|主題|其中|ㄧㄣ|女孩，|和連接|介於|主題|和這句話|謂詞的|它是|中午|女性氣質|於|(服務)。|4-|飲料:|一個動詞|過去時態，|和 haa|代名詞|演講者/第一人|活躍的元素，|結構|後|damma|於|地方|賓格的|和從:|一個粒子|所有格，|結構|後|蘇坤|非|一個地方|為它|從|屈折變化，|水:|所有格|通過從，|和標誌|其所有格的|kasra|很明顯，|和所有格介詞|這個詞使所有格|有關|由飲料，|鮮甜:|形容詞|為水，|形容詞和|所有格的|是所有格，|和標誌|其所有格的|kasra|表觀|於|它的結束。|問題|後|什麼|來之前|對象|ㄧㄣ|形容詞嗎?|進入|幾個|組件|劃分|形容詞嗎?|對象|ㄧㄣ|形容詞|真的嗎?|對象|ㄧㄣ|形容詞|偶爾的嗎?|對象|現在|事情|其中|追隨|在它|形容詞|True|被描述的詞嗎?|對象|其中|如下|形容詞|偶爾|於|男子氣概|和女性嗎?|對象|ㄧㄣ|確定嗎?|對象|ㄧㄣ|代詞?|對象|ㄧㄣ|專有名詞嗎?|對象|ㄧㄣ|名詞|指向/示範嗎?|對象|ㄧㄣ|名詞|關係代詞?|車廠|為每個|從|代詞，|專有名詞，|名詞|指向/論證、|和名詞|關係代詞|-|三|範例|於|一個句子|有意義。
GreatMasterpiece58=顆粒|結合|它說:|(章|結合)|和顆粒|結合|十年|和他們是:|waw /，|和美國聯邦航空局/和/所以/那時，|和那時/下一步，|或，|或，|或者，|但是，|而不是，|但是，|直到|於|部分|地方。|我說:|為連詞|兩層含義:|第一; 首先|語言|和其他|術語。|對於|它的意思|語言|然後是:|傾角/喜歡/附件，|你說:|以憐憫|任何人|後|任何人|以憐憫|與喜歡，|引用|它|有之前傾向的喜好|到它|和富有同情心的同情|身上。|和|連詞|於|術語|然後它是|兩個部分:|第一:|結合/同位語|實地調查，|和第二個:|連詞|協調。|然後為|結合/同位語|實地調查|然後它是|(從動件|惰性/靜態|顯示|其追隨者|於|確定性|具體來說|為它|於|不是確定性)|然後示例|結合/同位語的|實地調查|於|確定|(你來到我身邊|默罕默德|你的父親)|然後是你的父親:|結合/同位語|實地調查|後|默罕默德，|和每兩個|明確，|和第二個|於|該示例|使清楚/顯示|第一，|和示例|於|無限期|它說:|最高|(從|水|festering)(14:16)|然後潰爛|結合/同位語|實地調查|後|水，|和每兩個|無限期，|和第二個|於|該示例|指定|第一次。|和|連詞|協調|然後它是|(從動件|其中|在中間|它之間|和之間|其中一項是跟隨/詞如下|一|粒子的|結合)|和這些|顆粒|他們是:|1-|Waw /，|它是|為完全|加入;|所以它加入|由它|兩個連續的/以下，|就像:|(來了|默罕默德|和阿裡)|If|是|連接|在一起，|和加入|與它|在之前|後|延遲，|就像:|(來了|阿裡|和馬哈茂德)|If|是|連接|馬哈茂德|新的|後|連接|阿裡，|和加入|與它|延遲|後|在之前，|就像:|(來了|阿裡|和默罕默德)|If|是|連接|默罕默德|延遲|從|連接|阿裡。|2-|Fah/所以/那時，|它是|繼承安排|和以下/追求，|和意義|繼承: 安排的|那|第二|之後|第一，|和意義|以下/追求:|它|它追求/如下|與不|延遲，|就像:|(到達|馬兵|然後士兵)|If|是|連接|馬兵|新的|而不是|沒有|介於|到來|兩個締約方|延遲。|3-|然後，|它是|繼承安排|含有|偷懶/安排，|和意義|繼承/安排|當然|之前，|和意義|懶散的/安排:|那|介於|第一; 首先|和第二個|是一個延遲，|就像:|(發送|真主|Moses|然後|耶穌|然後|默罕默德|在他們身上|稱呼|與和平)。|4-|或，|它是|選擇|或|允許，|與差異|兩者之間|那|選擇|非|不允許/允許|與它|所有，|和可容許性|不允許|與它|所有;|然後示例|選擇|(嫁給|後腿|或|她的妹妹)|和示例|可容許性|(研究|教法法學|或|阿拉伯文語法)|然後當然|你有|從|伊斯蘭法|樣張|後|它|非|被允許的|一起|介於|後腿|和她的妹妹|與婚姻，|而不是|疑問|於|它|被允許的|一起|介於|教法法學|和阿拉伯文語法|在研究中。|5-|或，|它是|為請求|規範|之後|哈姆紮|質疑|就像:|(你學的嗎|教法法學|或|阿拉伯文語法嗎?)。|6-|或者，|與條件|那|它位於之前|與這樣的事情，|它是|類似|(或者)|於|這兩個意思|就像|它說:|最高:|(然後牢固地束縛|債券|任一|幫個忙/迫使他們通過設置他們自由|此後|或|採取 ransom)(47:4)，|和一樣:|(嫁給|任一|後腿|或|她的妹妹)。|7-|但是，|它是|信號/醒目/傑出，|和意義|它使|什麼|在它之前是|於|裁決|什麼是沉默/不回答|關於它，|就像:|(不|來了|默罕默德|但|巴克爾)|和所需|為契合|與它|兩個條件;|第一:|那|ㄧㄣ|緊接著是它的聯體字|與它|一類奇異|非|一個句子，|和第二次:|那不|先于|提問的粒子。|8-|不，|它是|否定|這其中|在它之後是|相同或自我|執政的|其中|建立/確認|為此，|在它之前|就像:|(來了|巴克爾|非|哈立德)。|9-|但是，|它是|引用|後|核准|資訊|那|在它之前是|並建立/確認|它的對面|為此，|在它之後是|就像:|(不|我愛|那些懶惰的人|但|勤勞的工人 / 那些勤奮的人)|和所需|那|它前面|否定|或|禁止，|和那|ㄧㄣ|為以下/聯體一詞|與它|奇異，|而那不是|它前面|waw / 和。|10-|直到，|它是|為逐步/先進性|和目標/目的/目的，|和逐漸/先進性:|它是|是指|後|傳球/流逝|資訊|一件事|然後/後另一件事，|就像:|(模具|成員|相等|先知)。|談|(直到)|正在啟動|其他比|結膜，|If|是|什麼|在它之後是|一個句子，|就像:|(來了|我們的朋友|相等|哈立德|出席)|和談|所有格|就像|它說:|最高:|(直到|休息時間產生|dawn)(97:5)|並為此|曾說|作者|(和直到|於|部分|地方)。
GreatMasterpiece59=這項裁決|粒子的|結合|它說:|然後如果|被連體|後|主格案例/指示心情|這將是主格案例/指示心情，|或|後|賓格案件語氣|它將是賓格的案例/虛擬語氣，|或|後|所有格|這將是所有格，|或|後|命令的心情|它將命令的心情，|你說:|(站在|宰|和 Amr，|我看見|宰|和 Amr，|和我通過|由紮伊|和 Amr，|與紮伊|沒有|矮櫃|也沒有|坐)。|我說:|這些|顆粒|十|成為|什麼|是在他們以後|粉絲|為此，|在他們面前的是|於|其執政|拐點，|然後如果|是|被跟蹤的聯體字|主格|是|從動件/連體|主格，|就像:|(遇見我|默罕默德|和哈立德)|然後哈立德:|皮帶機|後|默罕默德，|和乙肝|後|主格|是主格，|和標誌|它主格的|是 damma|很明顯，|如果|是|這個詞被人跟蹤|賓格|是|從動件|賓格|就像:|(我見過|默罕默德|和哈立德)|然後哈立德:|皮帶機|後|默罕默德，|和乙肝|後|賓格|是賓格|和標誌|其賓格的|是罰的罵|很明顯，|如果|是|這個詞被人跟蹤|所有格|是|從動件|所有格|它的示例中，|就像:|(我通過|由穆罕默德|和哈立德)|然後哈立德|皮帶機|後|默罕默德，|和乙肝|後|所有格|是所有格，|和標誌|其所有格的|kasra|很明顯，|如果|是|這個詞被人跟蹤|命令的心情|是|從動件|命令的心情|此外，|就像:|(沒有|參加|哈立德|或|傳送|信使號)|然後發送:|皮帶機|後|參加，|和乙肝|後|命令的心情|是命令的心情，|和標誌|其命令的|蘇坤。|從|這些|範例|你知道的|那|名詞|皮帶機/附加|後|名詞，|和那|動詞|皮帶機/附加|後|動詞。|練習/演習|1-|付諸表決|皮帶機|適當的|之後|粒子|結合|提到|於|例子|給出:|(仲裁)|非|我買了|一本書|但|......|() b|Not|我吃了|一個蘋果|但|......|() c|組建|我的兄弟|一座房子|RD|......|() d|出席|學生|然後|......|() e|我走了|這一天|星期四的|RD|......|() f|LEFT|那些|與研究所|直到連|......|() g|陪|那些人都好|非|......|() h|Not|我參觀了|我的兄弟|但|......|2-|付諸表決|皮帶機|在上面|適當的|於|地點|空閒|從|例子|給出:|(仲裁)|用餐|從|水果|......|非|生/綠色|() b|仍然是|由你|你的父親|......|或|一些|天數|() c|非|我讀過|這本書|......|但|其中一些是|() d|非|我看見|......|但|他代表/監工|() e|排列|......|和你的工具或手段|() f|我一路向|到|......|然後到亞歷山德里亞|() g|讓我吃驚|......|非|他的演講/語錄|() h|這兩個|你喜歡嗎|......|或|夏天。|3-|車廠|每個|word|從|單詞|給出了|於|兩句話，|所以|ㄧㄣ|於|兩個之一|皮帶機|中和|第二|皮帶機|它:|學者，|葡萄，|宮殿，|開羅，|他旅行，|他吃了，|勤奮的工人，|虔誠，|Ahmad，|歐麥爾|父親|· 貝克爾的|閱讀，|他寫道。|練習/演習|後|拐點|活用|句子|給出:|非|我看見|默罕默德|但|他代表/工頭，|來拜訪我們|你的兄弟|和他的朋友，|我的兄弟|吃|和飲料|好多。|答案/回應|1-|不是:|粒子|否定，|結構|後|蘇坤|非|一個地方|為它|從|屈折變化，|鋸|從|我看見:|一個動詞|過去時態|結構|後|罰的罵|應該|後|它的結局|防止|從|其明顯|函式|這個地方|與蘇坤。|及 taa|代詞|演講者/第一人|活躍的元素，|結構|後|damma|於|地方|主格。|默罕默德:|採取行動|由它|賓格|和標誌|其賓格的|罰的罵|很明顯，|但:|一個粒子|結合，|代表/監督:|皮帶機|後|默罕默德，|和乙肝|後|賓格|是賓格|和標誌|其賓格的|罰的罵|很明顯，|和代表/監督|附加/擁有|和 haa|代詞|其他/第三人的|連接藏有|到它，|結構|後|damma|於|地方|所有格。|2-|訪問:|一個動詞|過去時態|結構|後|罰的罵|非|一個地方|為它|從|屈折變化，|和我們:|採取行動|由它|結構|後|蘇坤|於|地方|賓格的|哥哥:|活動元素|主格，|和標誌|它主格的|waw|更換|從|damma|因為它|是從|名詞|五、|和兄弟|附加/擁有|和 kaf|代詞|處理/二人|連接藏有|到它|結構|後|罰的罵|於|地方|所有格，|和 waw|粒子|結合，|和朋友|皮帶機|後|哥哥，|和乙肝|後|主格|是主格，|和標誌|它主格的|damma|很明顯，|和朋友:|附加/擁有|和 haa|代詞|其他/第三人的|連接藏有|到它，|結構|後|damma|於|地方|所有格。|3-|Brother|從|我的兄弟:|一門學科|主格|開始，|和標誌|它主格的|damma|應該|後|它的結局|防止|從|其明顯|函式|這個地方|與母音跡象|適當情況下，|和兄弟|附加/擁有|和嚴|演講者/第一人|連接藏有|到它，|結構|後|蘇坤|於|地方|所有格，|他吃:|一個動詞|現在時態|陳述語氣|為其免費|從|虛擬語氣|與命令，|和標誌|它主格的|damma|很明顯，|和活動元素|代詞|隱藏|在它|允許|其所謂|ㄧㄣ|返回|後|我的兄弟，|和這句話|從|動詞|和活動元素|於|地方|主格的|謂詞|問題，|和連接|介於|這句話|謂詞的|和主題|ㄧㄣ|代詞|隱藏|於|(他吃)|和 waw|粒子|結合|他喝的|一個動詞|現在時態|皮帶機|後|他吃了，|和乙肝|後|陳述語氣|是陳述語氣，|和標誌|它指示性的|damma|很明顯，|好多：|採取行動|由它|因為他吃，|賓格|和標誌|其賓格的|罰的罵|明顯。|問題|對象|ㄧㄣ|結合嗎?|進入|幾個|組件|劃分|結合嗎?|對象|ㄧㄣ|連詞|實地調查的嗎?|車廠|為契合|實地調查|兩個例子。|對象|ㄧㄣ|連詞|協調嗎?|對象|意思是|waw 的 / 和?|對象|是的意義|(或者)?|對象|是的意義|(是)?|對象|其中|必要的|為契合|與但嗎?|對象|其中|必要的|為契合|含有|(但) 嗎?|哪些東西|股票|皮帶機|和乙肝|在上面嗎?|活用|句子|給出了|和是指|皮帶機|和乙肝|在上面|與儀器|結合|(|而且我們在帶走了|孩子們|以色列的|海|嗓門糙那時/追趕他們|法老|和他的 troops)(10:90)|(所以給|相對|親密的|他的權利|和窮人|越走越遠|方式|)(30:38)|(美化|真主確|什麼|在其中|諸天|和地球||他是|全能的上帝|Wise)(57:1)|(和肯定|從|人民|這本書的|那些是誰|相信|在安拉|和什麼|揭示了|給你|和什麼|揭示了|對 them)(3:199)|(和很快|會給你|你的主|那，你會高興的|() 5|沒有|他找到你|一個孤兒|然後庇護你|() 6|還是找到了你|迷了路|然後指導你|() 7|還是找到了你|有需要的人的需要|然後濃縮/提供的 you)(93:5-8)|(然後|地獄之火|把他成|() 31|然後|於|鏈|它的長度|七十|肘|然後綁定/插入 him)(69:31-32)。
GreatMasterpiece60=強化重點/並列，|和它的類型，|和其裁決|它說:|(章|強化重點/同位語) 的|重點:|(一個追隨者|為強調明確的詞|於|它主格|和其賓格|和其所有格|和其確定性)。|我說:|重點|-|它是說|重點|-|它的意思|於|語言:|加強所加劇，|你說:|(我已確認|東西)|和你說:|(我已確認)|此外:|If|加強它。|它是|於|術語|語法|兩種，|第一:|強化重點 /|口頭，|和第二個:|強化重點 /|意義。|對於|強化重點 /|語言:|然後是|與重複|表達/發音|和其重複|由本身|或|與它的同義字，|是否|是|一個名詞|就像|(來了|默罕默德|默罕默德)|或|是|一個動詞|就像|(來了|來了|默罕默德)|或|是|一個粒子|就像|(是的|是|來了|默罕默德)|就像|(來了|出席|父親|巴克爾) 的|RD|(是的|是|來了|默罕默德)。|和|強化重點 /|意義|然後是:|(從動件|其中|引發|概率|缺席 mindedness/疏忽/遺忘的|或|擴展/誇大/誇大|於|以下)|和澄清|此|那你|If|說:|(來了|領導)|可能性|那你|心不在焉|或|擴大|於|演講，|和那|你的意圖|是的到來|使者|領袖，|然後如果|你說:|(來了|領袖|他自己)|或|你說:|(來了|領袖|他自己)|他養了|可能性|並建立了/確認它|含有|攔截器|那你|沒有|打算/說/提|除了|到來|領袖|他自己。|和執政的|這|粉絲|它|同意|這個詞被人跟蹤|於|其拐點|後|意義|它|If|是|這個詞被人跟蹤|主格|是|從動件|主格|此外，|就像|(出席|哈立德|他自己)|如果|是|這個詞被人跟蹤|賓格|是|從動件|賓格|喜歡它，|就像:|(我記得|古蘭經 》|所有的它 / 整個)|如果|是|這個詞被人跟蹤|所有格|是|從動件|所有格|諸如此類|就像:|(I 反映所設想|在|這本書|所有的它 / 整個)|和如下|還|於|其確定性，|像什麼|你看見|於|例子|所有這些。
GreatMasterpiece61=運算式|強化重點 /|意義|它說:|和是|與運算式|特定，|和他們是:|自我，|和自我/相同，|和每個/一切，|和整個/整體/一切，|和追隨者|複數/整個/整體/一切，|和他們是:|所有/一共/整體/全緣，|和所有/一共/整體/全緣，|和所有/一共/整體/全緣，|你說:|站在|宰|自己，|我看見|人民|所有的人，|與我擦肩而過|人民|所有。|我說:|為強化重點 /|通過的意義|有的運算式|特定|由已知|語法學家|誰|追隨|這次演講|阿拉伯人的|和從|這些|運算式:|自我|和同一/自我，|並且必須|那|高度重視|每個|一|從|這兩個|到|代詞|返回|後|確切的消息，被強調|-|與罰的罵|kaf 的|-|然後如果|是|確切的消息，被強調|單數|是|代詞|奇異，|和表達|重點|單數|此外，|你說:|(來了|阿裡|他自己)，|RD|(出席|巴克爾|他自己)|如果|是|確切的消息，被強調|複數|是|代詞|it|複數|與表達|重點|複數|此外，|你說:|(來了|男子|他們自己)，|RD|(出席|作家|他們自己)，|如果|是|確切的消息，被強調|雙;|然後最正確|那|ㄧㄣ|代詞|雙，|與表達|重點|複數，|你說:|(出席|兩個男人|他們兩個/自己)|RD|(來了|這兩位作家|他們兩個/自己)。|從|運算式|重點|(所有/每一)，|和它的同類|(整個/整體/一切)|它是一個條件|在兩個和兩個|已連結|每個|從這兩個|到|代詞|追蹤|確切消息，被強調的|就像:|(來了|軍隊|整個/所有的它)|RD|(出席|男子|一共)。|從|運算式|(整個/整體/一切)|而不是|強調|與此|運算式|著名主導方式|除了|之後|運算式|(每個/一切)|和從|著名主要方式|它說:|最高|(然後伏|天使|所有這些|together)(15:30)|和從|其他比|著名主要方式|這句話|Raajiz:|然後|我會保持|哭泣|為永恆|全部|也許|有必要|到|增加/擴展|加強/強化，|令人驚訝|之後|整個/整體/一切|與運算式|其他，|和他們是:|(所有/一共/整體/整個)|RD|(所有/一共/整體/整個)|RD|(所有/一共/整體/整個)，|和這些|運算式|非|強調|與他們|獨立/靠自己，|就像:|(來了|人民|全部|一起|所有這些|一共)|和阿拉|知道。|練習/演習|後|拐點|活用|句子|給出:|我讀過|這本書|所有的它。|來拜訪我們|部長|他自己。|迎接我的|後|你的兄弟|自己在人/個人。|來了|男子|軍隊的|一共。|1-|已閱讀:|一個動詞|過去時態，|結構|後|罰的罵|應該|後|它的結局|防止|從|其明顯|函式|地方|與蘇坤|參展商|為排斥|不喜歡|繼承|四|母音的跡象|在什麼|ㄧㄣ|像這個詞|一個人，|及 taa|代詞|演講者/第一人|活躍的元素，|結構|後|damma|於|地方|主格的|和這本書:|採取行動|由它|賓格|和標誌|其賓格的|罰的罵|很明顯，|和所有:|強調|這本書，|並強調|賓格的|是賓格|和標誌|其賓格的|罰的罵|很明顯，|和所有|連接藏有|和 haa|代詞|其他/第三人的|附加/擁有|到它，|結構|後|damma|於|地方|所有格。|2-|訪問:|一個動詞|過去時態，|結構|後|罰的罵|非|一個地方|為它|從|屈折變化，|我們:|採取行動|由它|結構|後|蘇坤|於|地方|賓格的|和主任:|使用中的元素|訪問|主格，|和標誌|它主格的|damma|表觀|於|它的結局，|和自我:|強調|為主任，|和重點|主格的|是主格，|和標誌|如果其主格|damma|很明顯，|和自我|連接藏有|和 haa|代詞|其他/第三人的|連接藏有|到它，|結構|後|damma|於|地方|所有格。|3-|迎接我:|一個動詞|和積極的元素，|後:|一個粒子|所有格的|結構|後|蘇坤|非|一個地方|為它|從 /|屈折變化，|哥哥:|所有格|通過後，|和標誌|其所有格的|是啊|更換|從|kasra|因為它|是從|名詞|五、|和兄弟|附加/擁有|和 kaf|代名詞|處理/二人|連接藏有|到它，|結構|後|罰的罵|於|地方|所有格，|自我的人/個人:|強調|為兄弟，|和重點|所有格的|是所有格，|和標誌|其所有格的|kasra|很明顯，|和自我的人/個人|附加/擁有|和 haa|代詞|其他/第三人的|連接藏有|到它，|結構|後|kasra|於|地方|所有格。|4-|來了:|一個動詞|過去時態|結構|後|罰的罵|非|一個地方|為它|從|屈折變化，|男女:|使用中的元素|主格，|和標誌|它主格的|damma|表觀|於|它的結局，|男女|附加所擁有，|和軍隊:|連接藏有|到它|所有格，|和標誌|其所有格的|kasra|很明顯，|和所有:|強調|男人，|和重點|主格的|是主格，|和標誌|它主格的|damma|很明顯，|和所有|附加所擁有，|和他們:|代詞|複數|其他/第三人的|連接藏有|到它，|結構|後|蘇坤|於|地方|所有格，|一共:|強調|第二個|主格，|和標誌|它主格的|waw|更換|持續|damma|因為它|是複數|男性|聲音。|問題|對象|ㄧㄣ|重點嗎?|進入|幾個|組件|劃分|重點嗎?|車廠|三|範例|不同|為重點|口頭，|什麼|ㄧㄣ|運算式|其中|已使用|於|強調|抽象的嗎?|對象|其中|必要的|為重點|與自我|與相同或自我嗎?|對象|其中|必要的|為重點|與每個/一切|和整個/整體/一切嗎?|  音  |已使用|(一共)|於|強調|其他比|之前|由全/每一嗎?|活用|例子|給出:|其中|人員|你接受|他的行為/屬性|他自己嗎?|學生|所有這些|是成功的|我看見|阿裡|自己的人，|我參觀了|兩個老男人/shaykhs|他們兩個。
GreatMasterpiece62=替代|和其裁決|它說:|當|我替換|一個名詞|從|一個名詞|或|一個動詞|從|一個動詞|它遵循|於|全部|它的拐點。|我說:|替代|它的意思|於|語言:|替代交換|你說:|我替換用代替|這/像這樣|與那/像這樣，|和我替換用代替|這/像這樣|從|那/像這樣，|你想要|那你|替代它|為它。|它是|於|術語|語法|(從動件|目的|執政的|沒有|手段/仲介/介質)。|和其裁決|它|如下|取代|從它|於|其拐點|後|意義|它|If|是|取代|從它|主格|是|替代|主格，|就像:|(出席|亞伯拉罕 ·|你的父親)|如果|是|取代|從它|賓格|是|替代|賓格|就像:|(我見過|亞伯拉罕 ·|他的弟弟)|如果|是|取代|從它|所有格|是|替代|所有格，|就像:|(我喜歡/讓我吃驚|字元方式|穆罕默德的|你的叔叔)|如果|是|取代|從它|命令的心情|是|替代|命令的心情，|就像:|(無論是誰|謝謝你|他的主|prostrates|給他|將成功)。|種類|替代的|它說:|它是|後|四|部件:|替代/更換|東西|從|東西，|和替代|某些部分|從|整體，|和替代|安全殼/包容性|和替代|不正確/錯誤，|就像|你說:|(站在|宰|你的兄弟，|我就吃了|一卷/條麵包|第三，|和給我帶來好處|紮伊德|他的知識，|我看見|紮伊德|馬)，|你想要|那|你說的|那匹馬|然後以犯錯誤以為|然後代|紮伊德|從它。|我說:|替代|後|四|種類:|那種|第一:|代/更換|整個|從|整體，|它被稱為|替代產品|完成/絕對，|和它的一般規則:|那|ㄧㄣ|替代|一樣|取代的|從它，|就像:|(拜訪了我|默罕默德|你的叔叔)。|那種|第二:|替代|某些部分|從|整體，|和它的一般規則:|那|ㄧㄣ|替代|部分|從|取代|為它，|是否|它是|較少|從|剩下的人|或|等於|到它|或|更多資訊|比它，|就像:|(我記得|古蘭經 》|它的第三個)|或|(它的一半)|或|(三分之二的它)|和基本|於|此|種類|那|已連結|到|代詞|返回|到|取代|從它，|像什麼|你看見。|那種|第三:|替代|安全殼/包容性|和它的一般規則:|那|ㄧㄣ|介於|替代|和取代|從它|連接|沒有|整個完整|或部分/部分，|和基本|在它|附件/藏建設|替代的|到|代詞|返回|到|取代|為它|此外，|就像:|(我喜歡/讓我吃驚|那個女孩|她的發言)|RD|(給我帶來好處|這位教授|好|他的性格)。|那種|第四:|替代|錯誤/不正確，|與此|種類|後|三|規則:|1-|替代|清除，|和它的一般規則:|那|你想說|東西|然後你說，|然後|它似乎變得清晰|給你|那|要將其更改為|什麼是更好|比它|然後你改變|到它，|和那|像什麼|If|你說:|(這件事|女孩|是一個滿月)|然後|你說|之後|:|(太陽)。|2-|替代|健忘/心不在焉，|和它的一般規則:|那|你構建|你的話語|於|第一; 首先|後|感知你的懷疑，|然後|你知道的|其不正確|所以你會改變|從它，|像什麼|If|你看見|一個圖的形狀/人|從|遠|然後它變得清晰|一個人|然後你說:|(我見過|一個人)|然後|附近的|從你|然後你發現它|(馬)|然後你說:|(馬)。|3-|替代|錯誤/不正確，|和它的一般規則:|那|你打算|字數|然後說之前|你的舌頭|到|其他比它|前後|念念說 /|你改變|到|什麼|你想要或意欲|第一，|就像:|(我見過|默罕默德|那匹馬)。|演習/練習|1-|歧視|種類|替代的|包含|於|句子|給出:|讓我快樂|字元|穆罕默德的|我們的鄰居，|我看見|這艘船|其帆，|給我帶來好消息|我的妹妹|法蒂瑪|這即將來臨的|我的父親，|讓我吃驚|花園裡|它的花朵，|把我嚇壞了|獅子|它的吼聲，|我喝了|水|親愛，|我來了|到|這房子|這座清真寺，|我騎|火車|那匹馬。|2-|付諸表決|於|每個|地方|從|地方|空閒|替代|適當情況下，|並將其放置|與母音符號:|(仲裁)|我感到很榮幸|你的兄弟|......|和舊的|() b|來了|朝聖者|......|和他們走的人|() c|尊重|全部|家人的人|......|和他們的女人|() d|美國|整個|國家|......|和它的老人|3-|付諸表決|於|每個|地方|從|地方|空閒|替代|完成/絕對/相對應|適當的|和地方|與母音符號:|(仲裁)|是|指揮官|信徒的|......|一個典範|司法/公平的|() b|被稱為|哈裡發/繼任者|先知鋸|......|善良/柔軟|心|() c|是快樂|法官|......|那|是推進/上升|他民族。|() d|旅行|我的兄弟|......|到|亞歷山德里亞。|4-|付諸表決|於|每個|地方|從|地方|空閒|替代|安全殼/包容性|適當情況下，|和一般規律|與母音符號:|(仲裁)|高興/很高興我|花園裡|你的房子|......|() b|讓我吃驚|老師|......|() c|我打了我的信心|和你的朋友|......|() d|我很高興|與此|學生|......|() e|我愛|默罕默德|......|() f|我很高興|哈立德|......|5-|付諸表決|於|每個|地方|從|地方|空閒|取代|為它|適當情況下，|並將其放置|與母音的跡象，|然後|請參閱|那種|替換:|(仲裁)|給我帶來好處|......|他的知識|() b|我買了|......|它的一半|() c|拜訪了我|......|默罕默德|() d|If|......|你的父親|你尊重他|然後你就會成功|() e|給我我喜悅/高興 / 我高興|......|它的花朵。|() f|我踏上|一段旅程|long|我騎|關於它|......|一輛車|問題|對象|ㄧㄣ|替代嗎?|在什麼|如下|替代|取代|為它嗎?|進入|幾個|組件|劃分|替代嗎?|對象|其中|必要的|於|替代|某些部分|和替代|安全殼/包容性?|對象|是的一般規則|替代的|整體?|對象|是的一般規則|替代的|某些部分?|對象|是的一般規則|替代的|安全殼/包容性?|對象|ㄧㄣ|替代|錯誤/不正確嗎?|和什麼|它的部分?|和什麼|是的一般規則|所有的|部分嗎?|活用|例子|給出:|信使|真主|默罕默德|印章|之明證，|無法無法|阿拉伯人|從|生產|與古蘭經 》|十|詩句|從它，|讓我吃驚|天空|其明星。
GreatMasterpiece63=計數|接動名詞做賓語，|和他們一樣|它說:|(賓格|名詞)|接動名詞做賓語|五|十、|和他們是:|所作所為後|通過它，|和不定式|和副詞|時間，|和副詞|地方，|和條件，|和規格，|和除外/排除在外，|和名詞|不，|和呼格的名詞，|並採取行動 / 物件|持續|為了它，|並採取行動 / 物件|伴隨著它，|和謂詞|動詞，是的|和它的姐妹，|和名詞|當然賓/粒子的|和它的姐妹，|和追隨者|為賓格|和他們是|四|事情:|形容詞，|和一起，|並強調，|和替代。|我說:|讓賓格|名詞|If|位於|於|位置|從|五|十|職位。|我們將討論|後|每個|一|從|這些|位置|於|一章|指定為它，|後|手法方法|其中|我們曾之前/踏上它|於|這一章|nominatives，|我們讓|為它|這裡|範例|與目的|解釋|和澄清。|1-|這|位於|採取行動|通過它，|就像|(諾亞)|從|它說:|最高:|(事實上|我們發送|Noah)(71:1)。|2-|這|位於|不定式|就像|(幸福)|從|你說:|(是快樂的|默罕默德|幸福)。|3-|這|ㄧㄣ|副詞|地方|或|副詞|時間;|然後第一次|就像|(前面的|老師)|從|你說:|(我坐|前面|老師)|和第二個|就像|(一天|星期四)|從|你說:|(出席|我的父親|這一天|星期四)。|4-|這|位於|條件下，|就像|(覺得有趣)|從|它說:|最高:|(於是他 (所羅門) 笑了|amused)(27:19)。|5-|這|位於|一種規範，|就像|(汗)|從|你說:|(被打濕了|紮伊德|汗)。|6-|這|位於|例外/排除在外，|就像|(穆罕默德)|從|你說:|(出席|人民|除了|默罕默德)。|7-|這|位於|一個名詞|為 laa|否定，|就像|(學生|知識)|從|你說:|(沒有|學生|知識|是該受責備/虞)。|8-|這|位於|呼格的名詞，|就像|(信使|真主)|從|你說:|(O 信使|真主)。|9-|這|位於|一個物件|為了它，|就像|(作為紀律處分)|從|你說:|(嚴厲對待|這位教授|瞳孔|作為紀律處分)。|10-|這|位於|一個物件|伴隨著它，|就像|(帶燈)|從|你說:|(我已修訂|與燈)。|11-|這|位於|謂詞|動詞是|或|一|它的姐妹|或|一個名詞|當然賓/粒子|或|一|它的姐妹;|然後第一次|就像|(朋友)|從|你說:|(是|亞伯拉罕 ·|一位朋友|到阿裡)|和第二個|就像|(穆罕默德)|從|你說:|(我希望|默罕默德|來拜訪我們)|12-|這|位於|形容詞|為賓格|就像|(尊敬)|從|你說:|(我朋友/成為了朋友|默罕默德|尊敬)。|13-|這|位於|皮帶機|後|賓格|就像|(巴克爾)|從|你說:|(擊中/擊/擊敗|哈立德|Amr|和巴克爾)。|14-|這|位於|重點|為賓格|就像|(全部)|從|你說:|(我記得|古蘭經 》|所有的它)。|15-|這|位於|替代|從|賓格|就像|(它的一半)|從|它說:|最高:|(站在守夜|在黑夜|除了|一點兒|() 2|它的一半|或|降低|從它|little)(73:2-3)。
GreatMasterpiece64=物件/行事|由它|它說:|(章|物件/行事|由它)|和它是:|名詞，|賓格|其中|位於|在上面|動詞，|就像|你說:|我打節拍擊中|紮伊德，|我騎|那匹馬。|我說:|物件/行事|由它|根據被叫|到由|語法學家|後|這其中|結合|三|事情:|第一，|那|ㄧㄣ|名詞，|然後不|ㄧㄣ|物件/行事|由它|一個動詞|或|一個粒子。|和第二次:|那|ㄧㄣ|賓格;|然後不|ㄧㄣ|物件/行事|由它|主格|而不是|所有格。|和第三:|那|ㄧㄣ|動詞|活動元素的|當然|發生/發生/正在發生|在其上，|和的意思|由其發生/發生|在上面|其附|有了它，|是否|是|那|從|外的方式|確認，|就像|(我理解|這一課)|或|是|後|外的方式|否定，|就像|(沒有|瞭解|課)。|種類|物件/行事|由它|它說:|它是|兩個部分:|明顯的/名詞，|並暗示/代詞;|然後明顯|非|開始|它的提及，|和默示|兩個部分:|附加，|和失散，|金及附加|是兩個|十、|和他們是:|他命中/擊敗我，|和他命中/擊敗我們，|和他命中/擊敗你陽剛，|和他命中/擊敗你女性，|和他命中/擊敗你們兩個，|和他命中/擊敗你所有男性，|和他命中/擊敗你所有女性，|和他命中/擊敗他，|和他命中/擊敗她，|和他命中/擊敗他們兩個，|和他命中/擊敗他們陽剛，|和他命中/擊敗他們女性。|和失散|是兩個|十、|和他們是:|我，|而我們，|和你陽剛，|和你的女性，|還有你們兩個，|和你所有男性，|和你所有女性，|和他，|和她，|和他們兩個，|和他們的男子氣概，|和他們的女性。|我說:|劃分|物件/行事|由它|到|兩個部分:|第一; 首先|很明顯，|和第二個|隱含。|肯定|你知道的|那|表觀|這其中|是指|後|它的意思|沒有|需要|到|連接|一位發言者的/第一人|或|收信人/第二人|或|另一/三人，|和那|暗示|這其中|非|是指|後|它的意思|除了|與連接|從|這些|連線|三;|然後示例|明顯|(命中/擊敗|默罕默德|巴克爾)|RD|(點擊率/節拍|哈立德|) Amr|RD|(拿起|伊斯梅爾|一朵花)|RD|(拿|伊斯梅爾|一朵花)。|並且劃分|暗示|賓格|into|兩個部分:|第一; 首先|附加，|和第二個|分隔。|對於|所附|然後是:|這其中|非|開始|與它|這次演講|而不是|是正確的|它是放會發生|之後|(除外)|於|所選內容。|和|分離|然後是:|這其中|開始|與它|這次演講|和是正確的|它是放會發生|之後|(除外)|於|所選內容。|所附|二|十|運算式:|第一:|是啊，|它是|揚聲器/第一人|一個人，|並且必須|那|分離|它之間|和之間|動詞|中午與|被稱為|中午|保護，|就像|(是對我百依百順|默罕默德)|RD|(是對我百依百順|巴克爾)|RD|(服從我|阿巴克爾)。|和第二個:|(我們)|它是|揚聲器/第一人|小菊|他自己|或|與他|別人比他，|就像|(服從我們|我們的太陽)。|和第三個:|kaf|與罰的罵|它是|為解決/二人|單數|男性，|就像|(怕你|你的兒子)。|和第四個:|kaf|與 kasra|它是|為解決/二人|單數|女性，|就像|(怕你|你的兒子)。|和第五個:|kaf|已連結|與它|米姆|和阿勒夫|它是|為雙|每秒處理人|不受限制，|就像|(他擔心你兩個)。|而第六:|kaf|已連結|與它|米姆|獨自一人，|它是|為複數形式|男子氣概|每秒處理的人，|就像|(他擔心你所有男性)。|和第七個:|kaf|已連結|與它|中午|與 shadda，|它是|為複數形式|女性氣質|每秒處理的人，|就像|(他擔心你所有女性)。|和第八:|haa|與 damma，|它是|其他/三人|單數|男性，|就像|(他又怕他)。|和第九屆:|haa|已連結|與它|阿勒夫|它是|其他/三人|單數|女性，|就像|(他擔心她)。|和第十屆:|haa|已連結|與它|米姆|和阿勒夫|它是|為雙|其他/三人|不受限制，|就像|(他擔心他們兩個)。|和第一次|十:|haa|已連結|與它|米姆|獨自一人，|它是|為複數|男子氣概|其他/三人，|就像|(他擔心他們男性)。|和第二個|十:|haa|已連結|與它|中午|與 shadda，|它是|為複數形式|女性氣質|其他/三人，|就像|(他擔心他們女性)。|並為分離:|二|十|運算式|此外，|和他們是|(物件代詞幹)|連接|與閻|揚聲器/第一人|獨自一人，|或|(我們)|對讚美的人|自己，|或|含有|別人比他，|或|與 kaf|與罰的罵|為解決/二人|單數|男性，|或|與 kaf|與 kasra|為解決/二人|單數|女性，|而不是|保守的秘密|在你身上|知道|休息/餘數。|和正確|那|代詞|ㄧㄣ|(物件代詞幹)|和那|這其中|在它之後是|連接，貼，附屬物|引用|後|演講者/第一人|或|收信人/第二人|或|缺席的一次、 三次人，|你說:|(我|服從|學生)|RD|(不|很聽話|學生|除了|對我來說)|並從它|它說:|最高:|(你獨自|我們崇拜|和你獨處時|我們要求 help)(1:5)|它說:|崇高:|(他吩咐|那不|你崇拜|除了|Him)(12:40)。|演習/練習|1-|付諸表決|代詞|分隔|適當的|於|每個|地方|從|地方|空閒|所以是|反對採取行動|有了它，|然後|請參閱|它的意思|之後|那|你放|與母音符號:|(仲裁)|O|學生|......|等待中|未來。|() b|O|女孩|......|期待|這個國家。|() c|O|神有意識|......|希望能夠|虔誠。|() d|O|女孩|......|等待中|你的父親。|() e|O|信徒|......|將獎勵|真主。|() f|當然|默罕默德|事實上|延遲|......|我等待著|長。|() g|這些|女孩|......|希望能夠|虔誠。|() h|阿默罕默德|非|我等待著|除了|......|2-|付諸表決|每個|名詞|從|名詞|給出了|於|一個句子|有意義|所以|ㄧㄣ|物件/採取行動|由它:|這本書，|樹上，|這支筆，|這座山，|這匹馬，|一雙鞋，|窗戶，|那所房子。|3-|變更|代詞|給出了|into|代詞|附加的|然後|成為|每個|一|從它|物件/採取行動|由它|於|一個句子|有意義:|他們兩個，|你所有男性，|我，|你所有的女性，|他，|你們兩個，|我們。|4-|給|為每個|動詞|從|動詞|給出了|使用中的元素|物件/採取行動|由它|有兩個意義:|他讀，|他看到，|他爬上了，|他騎著馬，|他買了，|他居住，|他打開，|他殺了，|他的玫瑰/爬上。|5-|車廠|六|句子，|和使|於|每個|個句子|兩個名詞|從|名詞|給出了|所以|ㄧㄣ|一|兩個名詞|活動元素|和其他|物件/直接賓語|由它:|默罕默德，|這本書，|阿裡，|這棵樹，|亞伯拉罕，|那根繩子，|哈利勒|水，|Ahmad，|消息/論文，|· 貝克爾|這個問題。|6-|給|七|個句子|有意義|所以|ㄧㄣ|每個|個句子|撰寫/寫/包括|從|一個動詞|活動元素|物件/採取行動|通過它，|和是|物件/採取行動|由它|代詞|分離，|與條件|那不|提到|代詞|一|兩次。|7-|給|七|個句子|有意義|所以|ㄧㄣ|每個|個句子|撰寫/寫/包括|從|一個動詞|活動元素|物件/採取行動|通過它，|和是|物件/採取行動|由它|代詞|附加，|與條件|那|ㄧㄣ|代詞|於|每個|一|不同|對它的兄弟。|問題|對象|ㄧㄣ|物件/行事|由它嗎?|進入|幾個|組件|劃分|物件/行事|由它嗎?|對象|ㄧㄣ|明顯的嗎?|車廠|三|範例|為物件/行事|由它|明顯。|對象|ㄧㄣ|暗示嗎?|進入|幾個|組件|劃分|暗示嗎?|對象|ㄧㄣ|暗示|連接嗎?|幾個|運算式|暗示|已連結|其中|位於|物件/行事|由它嗎?|對象|ㄧㄣ|暗示|分開?|幾個|運算式|暗示|分隔|其中|位於|物件/行事|由它嗎?|對象|其中|必要的|那|分隔|由它|介於|動詞|和嚴|演講者/第一人?|車廠|完成|三|範例|暗示|已連結|位於|物件/採取行動|通過它，|與同三|範例|其他|暗示|分隔|位於|物件/採取行動|由它。|活用|例子|給出:|然後不|怕他們|和恐懼 Me(5:3)。|與崇拜|真主|而不是|您將相關聯|與他|anything(4:36)。|這|是這本書|非|疑問||在它||指導|為虔誠|() 2|那些人|相信|在看不見的|並建立|禱告|和從什麼|向他們提供了|他們 spend(2:2-3)。|他們會得到回報|持續|壓迫|人|海侵/壓迫|與寬恕|和|邪惡|人|罪的工價|與善良。
GreatMasterpiece65=動詞不定式|它說:|(章|不定式) 的|動詞不定式|它是:|名詞，|賓格|其中|來自|第三個|於|共軛|動詞，|就像:|他打了，|他打了，|打。|我說:|當然|知道|作者|動詞不定式|它由|(其中|來自|第三個|於|共軛|及物動詞)|和意義|那|是它|If|曾說|給你|某人:|共軛|(他打)|例如，|那麼肯定你|提及|過去時態|第一，|然後|來自|與目前的緊張，|然後|用不定式|所以你說:|他確實打了，|他打了，|打。|並不是|目的|這裡|瞭解知道|不定式/名詞|本身，|當然什麼|目的|瞭解知道|物件|不受限制的/絕對/完成，|和它|ㄧㄣ|不定式/名詞，|它是|短語|從|(這其中|不是|資訊/謂詞|用什麼|是指|後|確認/強調|動詞|或|其種，|或|它的數位)。|然後我們說:|(不是|謂詞)|取出|為什麼|是|謂詞|從|動詞不定式/詞名詞|就像|你說:|(你的理解|是一種理解|精確)。|和我們說:|(用什麼|是指|......|等 / 等等)|意義|那|物件|絕對/完成|三|種類:|第一:|確認/強調|為其動詞|就像|(我記得|這一課|記憶的心)，|和一樣:|(我很高興|對您的到來|快樂)。|和第二個:|澄清|這類型的|行動/動詞，|就像:|(我愛|我的老師|像愛和愛|一個男孩|他的父親)，|和一樣:|(我站|這位教授|站立|有禮貌)。|和第三個:|澄清|數量計數|就像:|(我打|懶人|兩次)，|和一樣:|(我打了他|三|倍)。|種類|不定式/名詞|絕對/完成|它說:|它是|兩個部分:|發音/言語，|而語義/方面的意義，|然後如果|同意|它的發音|發音|其動詞的|然後它是|發音/言語，|就像:|殺了他|殺戮/致命，|如果|同意|意義|其動詞的|沒有|其送電|然後它是|語義/有關的意思，|就像:|我坐在|坐在上下，|和我站在|一個站/向上/高高的|和什麼|是類似于|那。|我說:|劃分|動詞不定式|其中|讓賓格|後|它|是一個物件|完成/絕對|into|兩個部分:|第部分|第一:|這其中|同意|動詞|賓格|為它|於|其運算式，|與那|ㄧㄣ|內含|後|它的字母，|中和|意義|還|與那|ㄧㄣ|意義|目的|從|動詞|它是|意義|目的|從|不定式，|和那|就像:|(我坐|坐/向下)，|RD|(我打敗他|毆打吃力地)|RD|(去|去/第四)|和什麼|是類似于|那。|和部分|第二:|什麼|同意|動詞|賓格|為它|於|它的意思，|而不是|它同意|於|它的字母，|與那|ㄧㄣ|字母|不定式的|其他比|字母|動詞，|和那|就像:|(我坐|坐/向下)|然後如果|意義|(坐)|它是|意義|坐，|那麼就不是|字母|這個詞的|一個人，|和喜歡|那|(我變得快樂|幸福與喜悅/快樂)|RD|(我打敗他|一擊)|RD|(我羞辱他|羞辱/令人尷尬的)，|RD|(我站|站起來/大)|和什麼|是類似于|那，|和阿拉|光榮是他|和是崇高|最|而且他知道。|演習/練習|1-|車廠|每個|動詞|從|動詞|給出了|於|兩個句子|有意義，|並給出|為每個|動詞|與它的不定式|賓格|後|它|是一個物件|絕對/完成:|確認/重點|為操作的動詞|有一次，|與指定|為它的種類|預付方案|其他:|他能記住。|他喝了。|他演奏。|他請求寬恕。|他賣掉。|他感動。|2-|車廠|每個|名詞|從|名詞|給出了|一個物件|完成/絕對|於|一個句子|有意義:|要記住。|來玩|靜靜地。|出售|從必要性。|要走|快速。|要清醒|長。|對憤怒|獅子。|跳轉|老虎。|進行了總結。|3-|付諸表決|一個物件|絕對/完成|適當的|於|每個|地方|從|地方|空閒|給出:|(仲裁)|擔心|阿裡|......|() b|出現|滿月|......|() c|爆發|這座火山|......|() d|離開|空閒的談話嘲弄|......|() e|保持距離|在開玩笑|......|() f|水煮|烹飪的水壺/鍋爐|......|() g|水浸|尼羅河的|......|() h|哭了|寶貝|......|問題|對象|ㄧㄣ|不定式?|對象|ㄧㄣ|物件|完成/絕對?|進入|幾個|劃分|物件|完成/絕對|從|面|什麼|打算|從它嗎?|進入|幾個|組件|劃分|物件|絕對/完成|從|條件|它等於|為其動詞|或以其他方式嗎?|車廠|三|範例|物件|絕對/完成|確認/強調|其動詞|成為|三|範例|物件|絕對/完成|指定|對於那種|動詞的|成為|三|範例|物件|絕對/完成|指定|為數量計數|成為|三|範例|為一個物件|絕對/完成|賓格|與動詞|從|其運算式，|與同三|範例|為一個物件|絕對/完成|賓格|與動詞|從|它的意思。
GreatMasterpiece66=副詞|時間，|與副詞|地方|它說:|(章|對副詞|時間，|與副詞|地方)|副詞|時間|它是:|一個名詞|時間|賓格|與暗示|(中)|就像|一天，|夜晚，|清晨，|清晨，|和前一天休息的時間|今明兩天，|深夜人的第一第三|到了中午，午夜|和晚上，|和永遠/總是/無止境的|和很長的時間，|和一些時間。|和什麼|是類似于|那。|我說:|副詞|它的意思|於|語言:|容器容器|和預期|由它|於|自訂|語法學家的|物件|在它，|它是|兩種:|第一:|副詞|時間，|和第二個:|副詞|地方。|對於|副詞|時間:|然後它是|短語|從|名詞|其中|是指|後|時間|賓格|與運算式|引用|後|意義|事件的發生|那|意義|在它，|與注意到|意義|(在)|引用|後|狀語，|和那|示例|你說:|(我禁食|這一天|星期一的/秒)|然後當然|(一天|星期一的/秒)|副詞|時間|物件|在它，|它是|賓格|對你所說:|(封齋)|和那|操作的動詞|引用|後|意義|它是|禁食，|和這個詞|後|注意到|意義|(在)|其中:|那|禁食|發生了|於|這一天|所提到，|與差異|你說:|(恐懼|懶人|這一天|測試)|然後如果|意義|那|是它|恐懼|一個自我|這一天|測試的|並不是|它的意思|他|恐懼|東西|發生的事情|在|此|一天。|知道|那|時間|劃分|into|兩個部分:|第一; 首先|具體/有關，|和第二個|模糊/不清楚。|對於|具體/有關|然後它是|(什麼|是指|後|固定|特定|測量/金額|從|時間。|和|模糊/不清楚|然後它是|(什麼|是指|後|固定|其他比|特定|而不是|測量/金額)。|和示例|特定/有關:|月，|和一年，|一天，|和一年，|又一周。|和示例|模糊/不明:|目前，|和時間，|和時間，|和一些時間。|和每個|一|從|這兩個|種類|許可證|它的立場|後|它|是一個物件|在它。|肯定|提到|作者|從|運算式|引用|後|時間|二|十|運算式:|第一:|(天)|它是|從|日出|黎明的|到|設置|太陽，|你說:|(我禁食|一天)|或|(我禁食|這一天|星期四的五次)|或|(我禁食|一天|長)。|和第二個:|(夜)|它是|從|設置|太陽的|到|日出|黎明，|你說:|(幽自己|晚上|最後/昨天)|或|(幽自己|住一晚)|或|(幽自己|晚上|星期五)。|和第三個:|(清晨)|它是|時間|什麼|介於|禱告|黎明的|日出|太陽，|你說:|(拜訪了我|我的朋友|清晨|周日的/第一)|或|(他拜訪了我|清晨)。|和第四個:|(清晨)|它是|第一; 首先|一天，|你說:|(我來看你|清晨|星期六/安息日)，|RD|(我來看你|清晨)。|和第五個:|(黎明黎明前的時間)|它是|最後一次|夜的|只是之前|黎明，|你說:|(我已修訂|這一課|只是之前黎明/黎明)。|而第六:|(明天)|它是|一個名詞|這一天|其中|之後|你的一天|其中|您|在它，|你說:|(如果|你來到我身邊|明天|我將以你為榮)。|和第七個:|(第一夜的黑暗/黃昏的三)|它是|一個名詞|第三名|夜的|第一，|你說:|(我會去拜訪你|第一第三夜的 / 黃昏)。|和第八:|(午夜至中午時/前本初子午線)|它是|一個名詞|時間|其中|到職|從|第一; 首先|一半|夜的|第二|到|中午的經絡，|你說:|(旅行|我的兄弟|午夜到中午)。|和第九屆:|晚上 (後本初子午線)|它是|一個名詞|時間|其中|到職|從|中午的經絡|到|一半|半夜了，|你說:|(到達/達成|火車|由我們|在晚上)。|和第十屆:|永遠/總是/無盡|和第一次|十:|(長時間):|和每個|從這兩個|一個名詞|為副詞|未來的|其中|非|目的/目標|對它的結局，|你說:|(不|我會交朋友/成為陪朋友 /|那些邪惡的人|過)|RD|(不|我已經犯下|邪惡|對於很長的時間)。|和第二個|十:|(一些時間)|它是|一個名詞|為副詞|含糊不明|其他比|知道|開始|和也不|結束|你說:|(我成了朋友|阿裡|一些時間|從|歲前)。|和加入|對那|什麼|其類似|從|每個|名詞|引用|後|副詞:|是否|是|具體/有關|示例|上午，|和上午，|或|是|模糊/不清楚/晦澀|示例|時間，|每小時，|並時刻/短時間/時，|和時間，|並時刻/短時間/時;|然後當然|這些|和那的|它的例子|它是允許允許 /|賓格|每個|一|從他們|後|它|是一個物件|在它。|副詞|地方|它說:|與副詞|地方|它是:|一個名詞|地方|賓格|與暗示|(在)，|就像:|前面，|和隱藏，|和前面的|和隱藏，|及以上，|及以下，|與在/由/，|和對面/面對/臉去面對，|和對面/面對/臉去面對，|和前面的|和那裡/在那邊，|在這裡，|和什麼|是類似于|那。|我說:|當然|你理解|在什麼|上一步|副詞|時間，|和它|劃分|into|兩個部分:|具體/有關，|模糊/模糊/不清不楚，|和你的理解|那|每個|一|從這兩個|允許許可證 /|其賓格|後|它|是一個物件|在它。|知道|這裡|那|副詞|地方|短語|從|(名詞，|引用|後|這個地方，|賓格|與運算式|引用|後|意義|發生|在它|通過注意/觀察|意義|(在)|是指|後|在狀語。|和它|還|劃分|into|兩個部分:|具體/有關，|和模糊/模糊/不清楚/非特異性的;|和|具體/有關|然後是:|(這其中|為它|形狀|和限制|局限性)|範例:|房子，|和清真寺，|和花園，|和花園;|和|模糊/模糊/不清楚/非特異|然後是:|(這其中|非|為它|形狀|也不是|限制|局限性)|範例:|在後面，|和前面。|而不是|允許許可證 /|那|讓賓格|後|它|一個物件|在它|從|這兩個|組件|除了|第二，|它是|模糊/模糊/不清楚;|持續|第一; 首先|-|它是|具體/有關|-|然後喜歡|其所有格|由粒子/介詞|所有格的|引用|後|本意，|就像:|(幽自己|於|這座清真寺)|RD|(我參觀|阿裡|於|他的房子)。|肯定|提到|作者|從|運算式|引用|後|地方|三|十|運算式:|第一:|(在前面的)|就像:|(我坐|前面|這位教授|很好-mannered /-行為端正)。|和第二個:|(隱藏)|就像:|(騎/移動|行人|在後面|乘客或騎手)。|和第三個:|(在前面的)|就像:|(走|該名員警|早于/的前面|領導/指揮官/王子)。|和第四個:|(隱藏)|就像:|(站在|崇拜者|其中一些|在後面|其他人)。|和第五個:|(上圖)|就像:|(我坐|如上|椅子上)。|而第六:|(下)|就像:|(站在|那只貓|如下|表)。|和第七個:|(與/上或其附近)|就像:|(為默罕默德|一站/等級|含有|這位教授)。|和第八:|(詳細)|就像:|(旅行/走|含有|所羅門|他的弟弟)。|和第九屆:|(相對於 / 面臨)|就像|(對我們來說|一座房子|相對於 / 面臨|尼羅河)。|和第十屆:|(相對於 / 面臨)|就像|(坐|我的兄弟|相對於 / 面臨|你的弟弟)。|和第一次|十:|(對面到/面對/在前面的)|就像:|(坐|我的兄弟|在前面的/對面|這房子|你的弟弟)。|和第二個|十:|(那裡)|就像|這句話|真主|最高:|(和我們親近了|有|others)(26:64)。|第三個|十:|(在這裡)|就像|你說:|(坐|默罕默德|這裡|一個時刻)。|和示例|這些|運算式|每個|這其中|提到|後|一個地方|模糊/模糊/不清楚/非特異性，|就像:|在右邊，|和左邊。|問題|和練習/演習|1-|對象|ㄧㄣ|副詞嗎?|進入|幾個|組件|劃分|副詞嗎?|對象|ㄧㄣ|副詞|時間嗎?|進入|幾個|組件|劃分|副詞|時間嗎?|車廠|三|範例|於|一個句子|有意義|為副詞|時間|指定/相關/有關，|與同三|範例|其他|為副詞|時間|含糊不清 / 晦澀 / 不清楚，|ㄧㄣ|作賓格|後|它|是一個物件|在它|每個|副詞的|時間嗎?|2-|車廠|每個|一|從|運算式|給出了|一個物件|在它|於|一個句子|有意義，|與指定|它的意思:|前三分之一的晚上/黑暗/黃昏，|午夜到早上/中午，|時間，|稍等，|上午晨光，|明天。|3-|對象|ㄧㄣ|副詞|地方嗎?|對象|ㄧㄣ|副詞|地方|目前還不清楚/模糊/模糊?|對象|ㄧㄣ|副詞|地方|指定/相關/有關，|成為|三|範例|為每個|從|副詞|地方|目前還不清楚/模糊/模糊，|與副詞|地方|具體/相關/有關，|ㄧㄣ|作賓格|後|它|是一個物件|在它|每個|副詞|地方嗎?|4-|提及|七|個句子|描述|在它|你的行動|在這一天|星期五，|與條件|那|包括|每個|個句子|後|一個物件|在它。
GreatMasterpiece67=條件|它說:|(章|條件)|條件|is:|名詞，|賓格|解釋|為此，|是模糊/模糊/可疑|從|條件時|就像|你說:|(來了|宰|騎馬)|RD|(我騎|那匹馬|它勝過一切)|RD|(我見過|僕人|真主|騎馬)|和什麼|是類似于|那。|我說:|條件|於|語言|(什麼|在上面|人類|從|好|或|壞或邪惡)|它是|於|術語|語法學家的|短語|從|(名詞，|附加/額外，|賓格|解釋|為此，|是模糊/模糊/可疑|從|條件/情況)。|和我們說:|(名詞)|包括|清除|舉個例子|(笑)。|內|你說:|(來了|默罕默德|笑著說)|包括|解釋|與清除|舉個例子|(笑)|於|你說:|(來了|默罕默德|他笑著說)|然後當然它|在其中|解釋|你說:|(笑)|和像那樣|我們說:|(來了|默罕默德|與他|他的弟弟)|然後當然它|在其中|解釋|你說:|(伴隨著|他的弟弟)。|和我們說:|(額外/其他)|它的意思|它|不是|部分|從|演講/詞;|那時/因此免費|從它|謂詞。|和我們說:|(賓格)|那時/因此免費|從它|主格|和所有格。|當然什麼|讓賓格|條件|與動詞|和類似于|動詞:|像這個名詞|積極元素/分詞，|和不定式|與副詞，|和名詞|指向/示範。|和我們說:|(解釋|為此，|晦澀/含糊不清|從|條件)|它的意思|那|條件|解釋|什麼|是隱藏的|和隱蔽|從|說明|那些擁有|知識|或|其他比他們。|接著|事實上它|可能|被|一種解釋|為描述|活動元素的|就像:|(來了|僕人|真主|騎馬)|或|解釋|為描述|物件/行事|通過它，|就像:|(我騎|那匹馬|它勝過一切)，|和的可能|被|可能|對於這兩種情況|在一起，|就像:|(我見過|僕人|真主|騎馬)。|像什麼|高光或來|條件|從|活動元素|/ 物件採取行動|由它|然後可能它|突出顯示來|從|謂詞，|就像:|(你|是我的朋友|真誠)，|和的可能|突出顯示來|從|所有格|從粒子/介詞|所有格，|就像:|(我通過|由後腿|騎馬)|和的可能|突出顯示來|從|所有格|附件/藏建設，|就像|它說:|最高:|(即|追隨|信條|亞伯拉罕的|直立|)(16:123)|然後直立:|條件|從|亞伯拉罕，|和亞伯拉罕|是所有格|與罰的罵|更換|從|kasra，|它是|所有格|與附件/藏建設|(信條)|到它。|條件|狀態|和條件|從動件/副教授|它說:|而不是|ㄧㄣ|除了|無限期，|而不是|ㄧㄣ|除了|之後|完成|演講中，|而不是|ㄧㄣ|其助理/追隨者|除了|明確。|我說:|找到|於|條件|那|ㄧㄣ|無限期，|而不是|允許許可證 /|那|ㄧㄣ|明確，|如果|來了|組成|在它|條件|正定|於|外觀，|然後當然它|是發現|解釋|此|確定性|由不確定性|示例|他們說:|(來了|領導者的指揮官/王子|在他自己的單獨)，|然後當然|(關於他自己的單獨)|條件|從|領導/指揮官/王子|然後它是|確定性|與附件/藏建設|到|代詞|而且因為它|於|解釋|是無限期|它是|你說:|(單/孤獨)|那麼喜歡你|你說:|(來了|領導者的指揮官/王子|獨自一人)，|和示例|，|他們說:|(他發送它|苦苦掙扎/戰鬥)，|其中:|戰鬥，鬥爭 /|RD|(他們來了|第一個可用|然後第一次)|其中:|序列的命令。|與起源|於|條件|那|來自|之後|按照實踐|講話 》|和意義|實現和完成|感言:|那|需要|動詞|其積極的元素|和主題|其謂詞。|也許|它是有必要|先于|條件|後|全部|組件|講話 》|像什麼|If|是|條件|名詞|質疑/疑問句，|就像:|(如何|什麼時候到|阿裡)|那麼如何:|一個名詞|質疑/疑問句|結構|後|罰的罵|於|地方|賓格的|條件|從|阿裡，|而不是|允許許可證 /|延遲|名詞的|質疑/疑問句。|包括|於|副教授/追隨者|條件|那|ㄧㄣ|明確，|然後不|允許許可證 /|那|ㄧㄣ|無限期|與其他比|理由及有良好的原因。|從什麼|辯解/使人有理由|來自|條件|從|無限期|那|開始|條件|在其上，|像這句話|詩人:|瑪雅|被遺棄的廢墟/遺骸|是一座房子|它顯示/變得可見|好像是|損壞/不完美/亮劍|然後拋棄了廢墟/仍然是:|條件|從|(房子)|和房子|無限期|和辯解|搜尋|條件|從它|它前面|在上面。|從什麼|辯解|搜尋|條件|從|無限期|那|指定|此|無限期|與附件/藏建設|或|描述|然後示例|第一個|於|它說:|最高:|(在|四|天/期|equal)(41:10)|然後相等:|條件|從|(四)|它是|無限期，|和辯解|搜尋|條件|在它|為是它|附加所擁有，|和示例|第二個|這句話|詩人:|你保存|主啊|諾亞|和授予|給他|於|一艘船|大|中/穿越|大海|已載入|演習/練習|1-|付諸表決|於|每個|地方|從|地方|空閒|給出了|條件|適當:|(仲裁)|傳回|學生|努力工作|到|他的國家|......|() b|不要|用餐|食品|......|() c|非|步行/旅行|在沿|這條路|......|() d|放入/磨損|你的衣服|......|() e|不要|睡眠|於|晚上|......|() f|傳回|我的父親|從|他的辦公室/理事會政府|......|() g|不要|步行|於|地球|......|() h|我看見|哈立德|......|2-|名次|每個|名詞|從|名詞|給出了|條件|澄清|條件|活動元素的|於|一個地方|有意義:|高興。|昂首闊步/詭詐。|光著身子。|熱。|累了。|Unshoed。|努力工作/勤奮。|3-|車廠|每個|名詞|從|名詞|給出了|條件|澄清|條件|物件/行事|由它|於|一個地方|有意義:|帶著鐐銬/綁起來/綁定。|令人傷心。|快。|清除/純。|清潔。|新增功能。|逗樂所笑。|光明/閃光/傑出。|盛開。|快樂/開朗。|4-|描述|那匹馬|四|句子，|與條件|那|來自|於|每個|個句子|與條件。|練習/演習|後|拐點|活用|這兩句話|給出:|遇見我|後腿|哭泣，|我穿了|服裝|新增功能。|回應/答案|1-|滿足:|一個動詞|過去時態|結構|後|罰的罵|非|一個地方|為它|從|屈折變化，|和 tah|標誌|女性的特質，|和名詞|為保護，|和嚴|代詞|演講者/第一人|物件/採取行動|通過它，|結構|後|蘇坤|於|地方|賓格的|和後腿:|活動元素|滿足|主格，|和一個標誌|它主格的|damma|很明顯，|而哭泣:|條件|澄清|條件|活動元素的|主格|與罰的罵|明顯。|2-|戴:|一個動詞|過去時態|結構|後|罰的罵|應該|後|它的結局|防止|從|其明顯|函式|地方|與蘇坤|來|與它|為推動|不喜歡|先後|四|母音|在什麼|ㄧㄣ|像這個詞|一個人，|和 tah|代詞|演講者/第一人|使用中的元素|結構|後|damma|於|地方|主格的|與服裝:|物件/採取行動|由它|賓格|和標誌|其賓格的|罰的罵|很明顯，|新增功能：|條件|澄清|條件|物件/行事|由它|賓格|和標誌|其賓格的|罰的罵|明顯。|問題|對象|ㄧㄣ|條件|語言|和術語嗎?|對象|其中|來自|條件|從它嗎?|  音  |來|條件|從|附加/擁有|到它嗎?|對象|其中|包括|於|條件下，|和什麼|其中|包括|於|副教授/追隨者|條件嗎?|對象|其中|辯解|搜尋|條件|從|無限期?|車廠|條件|三|例子，|和應用|後|每個|一|從他們|條件|條件|他們，每個人都|和改變他們。
GreatMasterpiece68=規格|它說:|(章|規範)|規格|它是:|名詞，|賓格的情況下，|解釋|為此，|不清楚|從|精華，|就像|你說:|(滴|紮伊德|汗水)|RD|(爆炸爆裂 /|巴克爾|在脂肪)|RD|(是好|默罕默德|人)|RD|(我買了|二十|書)|RD|(我擁有|九十歲|羊羊/女)|RD|(宰|是更光榮/高貴|比你|作為一位父親)|RD|(他是更美麗|比你|在面部外觀/外觀)。|我說:|為規範|於|語言|有兩層含義;|第一:|解釋|沒有任何例外/絕對，|你說:|我解釋|因此/像這樣，|你想要|那你|解釋所解釋;|和第二個:|分離|部分|事項|從|其他一些|你說:|我分離|人，|你想要|那你|個別|其中一些|從|其他一些。|與規格|於|術語|語法學家的|短語|從|(名詞，|明確的名詞，|賓格|解釋|為此，|不清楚|從|精華|或|關係/歸因)。|然後我們說:|(名詞)|它的意思|那|規格|非|ㄧㄣ|一個動詞|也不是|一個粒子。|和我們說:|(明確的名詞)|為消除/離開|名詞|解釋，|然後如果|規格|非|ㄧㄣ|一個句子|也不是|副詞，|與差異|條件|像什麼|以前|於|第一章。|和我們說:|(解釋|為此，|不清楚|從|精華|或|關係/歸因)|指示|到|那|規格|後|兩種，|第一:|規格|本質/發聲/口語，|和第二個:|規格|規格/歸屬/是顯而易見的。|對於|規格|本質|-|並要求|還|規格|單數|-|它是|(這其中|引發|默默無聞|一個名詞|提到|在它之前|完成|現實)|和是|之後|數位，|就像|它說:|最高:|(真正 i|鋸|一|十|stars)(12:4)，|(真正|數量|個月|含有|真主|是兩個|十|months)(9:36)|或|之後|測量，|從|稱重，|就像:|(我買了|一磅|油)|或|幹措施|就像:|(我買了|128 磅|小麥/幹粒) 的|或|地區，|就像:|(我買了|一個正方形|土地)。|和|規格|歸因，關係說明|-|被稱為|還|規格|這句話的|-|它是|(這其中|引發|默默無聞|屬性/關係|於|一個句子|新的|它)|它是|兩種類型;|第一:|改變，|和第二個:|其他比|多變。|然後為|多變|然後它是|後|三|種類:|那種|第一:|多變|從|活躍的元素，|和那|就像|(爆炸/爆裂|紮伊德|在脂肪)|起源|在它|(爆炸/爆裂|脂肪|紮伊德) 的|然後刪除|附加/擁有|-|它是|脂肪|-|和正在發生|附加/擁有|到它|-|它是|紮伊德|-|它的地方，|然後先進|中國的崛起，|然後|來自|與附加/擁有|缺席失蹤|然後是最後一個|後|規範。|那種|第二:|多變|從|物件/行事，|和那|愛好|它說:|最高:|(和規定作出突發|地球|rivers/springs)(54:12)|它的起源|(和規定作出突發|河流/彈簧|地球)|然後做|在它|示例|其中|之前。|那種|第三:|多變|從|主題|和那|就像|它說:|最高:|(I|更多資訊|比你|在 wealth)(18:34)|和它的起源|(我的財富|是更多|於|你的財富)|然後刪除|附加/擁有，|它是|(財富)|和正在發生|附加/擁有|到它|-|它是|代詞|其中|ㄧㄣ|是啊|演講者/第一人|-|它的地方|然後先進|它的崛起|和分離;|因為|是啊|演講者/第一人|代詞|已連結|像什麼|你明白，|它是|非|正在啟動|有了它，|然後|來了|與附加/擁有|缺席失蹤|然後是|規範，|然後成為了|什麼|你看看。|和|其他比|多變|然後就像|(填充|容器|水)。|條件|規範的|它說:|而不是|ㄧㄣ|除了|無限期，|而不是|ㄧㄣ|除了|之後|完成|講話。|我說:|包括|於|規格|那|ㄧㄣ|無限期，|然後不|允許許可證 /|那|ㄧㄣ|明確，|和|這句話|詩人:|我看見你|當後|那|你知道的|我們的臉/偉人|你轉身離去|你會快樂/同意|你自己|阿伊斯|持續|Amr|然後如果|它說:|(自我)|一種規範，|並不是|()|此|(另外/額外粒子)|正定|每當|有必要|從它|找到|規格|明確，|而是|它是|另外|非|目的是|什麼|輸入|明確;|然後它是|無限期，|它是|可以接受|為此，|提醒我們|從|條件。|而不是|允許/許可證|於|規格|那|先于|後|關於它，其動詞|而是|非|找到|除了|之後|完成|演講，|其中:|之後|完成和滿足感|動詞的|由其活躍的元素，|和主題|由其謂詞。|運動/演習|1-|請參閱|種類|規範的|很多細節|於|句子|給出:|我喝了|一杯|水，|我買了|磅/quintar|親愛的|我擁有|十|小塊|黃金，|我栽培播下了|一畝|棉制|我看見|一|十|馬兵，|我騎|火車|五十|乘客/旅行，|默罕默德|是更完美|從|哈立德|在字元|和更高貴|作為一個人|和更純|在無罪/完整性，|填充|亞伯拉罕 ·|與驕傲。|2-|付諸表決|於|每個|地方|從|地方|空閒|從|例子|規格|適當:|(仲裁)|金色|是更昂貴|......|於|銀。|() b|鐵|是強|......|於|鉛。|() c|學者們|是最誠實|人|......|() d|學生|知識|是更光榮/高貴|......|於|無知的人。|() e|長頸鹿|是最高的|動物|......|() f|太陽|是更大|......|於|地球。|() g|我吃了|五|十|......|() h|我喝了|一杯|......|3-|車廠|每個|名詞|從|名詞|給出了|規格|於|一個句子|有意義:|大麥，|甘蔗和讀取，|自然/字元，|道德，|喝酒，|笑，|力量，|勇氣。|4-|給|三|個句子|ㄧㄣ|於|每個|個句子|從他們|規格|前所未有|與名詞|計數，|與條件|那|ㄧㄣ|名詞|計數|主格|於|一|和賓格|於|第二|和所有格|於|第三部分。|練習/演習|後|拐點|活用|這兩句話|給出:|默罕默德|是更高尚/光榮|於|哈立德|自己作為一個人，|我有我|二十|手臂長度|絲綢。|答案/回應|1-|默罕默德:|一門學科，|主格|通過在開始，|和標誌|它主格的|damma|很明顯，|更多高尚/光榮:|述詞|問題，|主格|按主題、|和標誌|它主格的|damma|很明顯，|從|哈立德:|所有格|和所有格|相關|與更多高尚/光榮，|自己作為一個人:|規格|屬性/關係/描述|多變|從|主題|賓格|和標誌|其賓格的|罰的罵|明顯。|2-|以:|副詞|地方|相關|與缺席/失蹤|述詞|提出了一種，|和與|附加/擁有|和嚴|演講者/第一人|連接藏有|到它，|結構|後|蘇坤|於|地方|所有格，|二十:|一門學科|延遲|主格|開頭，|和標誌|它主格的|waw|更換|持續|damma，|因為它|是一種擴展|為複數形式|男性|聲音，|手臂長度:|規格|二十多個年頭，|賓格|與罰的罵|很明顯，|絲綢:|規格|手臂長度|賓格|與罰的罵|明顯。|問題|對象|ㄧㄣ|規格|語言|和術語嗎?|進入|幾個|組件|劃分|規格嗎?|對象|ㄧㄣ|規格|本質嗎?|對象|ㄧㄣ|規格|屬性/關係/描述嗎?|與什麼|被稱為|規格|本質嗎?|與什麼|被稱為|規格|屬性/關係/描述嗎?|對象|其中|發生|之前|規格|本質嗎?|車廠|為規範|本質|三|範例|不同|和活用|每個|一|從他們嗎?|進入|幾個|組件|劃分|規格|屬性/關係/描述|多變的嗎?|車廠|為規範|多變|從|活動元素|和從|物件/行事|和從|主題|成為|為規範|屬性/關係/描述|其他比|改變，|什麼|現在|條件|規範嗎?|對象|防止|從|規格|非|來|除了|之後|完成|講話嗎?|車廠|為規範|到它|規範。
GreatMasterpiece69=異常/驅逐|它說:|(章|例外/驅逐)|和顆粒|異常的|八項，|和他們是:|除外，|和其他比，|除了 / 其他比/與不同的是，|除了 / 其他比/與不同的是，|以及是否，|除了分開從|除了分開從|除了分開從。|我說:|異常|它的意思|於|語言|絕對/完成|去除/考慮了，|它是|於|術語|語法學家的|短語|從|(拿出/刪除|通過除外|或|一|它的姐妹，|東西|如果不是|那|以出/刪除|然後它本來.|進入|在什麼|之前|工具/工具)|和它的例子|你說:|(成功了|學生|除了|Amir)|然後當然|你拿掉刪除|與你說|(除外|Amir)|只有一個|學生，|他是|Amir，|如果不是|那|以關閉刪除|然後將已|Amir|進入|於|這句話|學生的|取得了成功。|知道|那|工具/工具|異常的|有很多，|和肯定|提到|從他們|作者|八|工具/文書，|和那些的|提到他們|從他們|後|三|種類:|那種|第一:|這其中|ㄧㄣ|一個粒子|永遠|它是|(除外)。|那種|第二:|這其中|ㄧㄣ|一個名詞|永遠|和他們是|四、|和他們是:|除了 / 以外 (不像)|與限制|和 kasra|所見，|RD|除了 / 以外 (不像)|與限制|和 damma|所見，|RD|(是否)|副檔名|和罰的罵|所見，|RD|(其他比)。|那種|第三:|這其中|ㄧㄣ|一個粒子|有時|和是|一個動詞|有時|其他，|和他們是|三|工具/文書，|和他們是:|(除了分開從)|RD|(除了分開從)|RD|(除了分開從)。|這項裁決|被排斥|通過除外|它說:|然後除外|通過除外|讓賓格|當|是|這次演講|完成|積極，|就像:|(以發言|人民|除了|紮伊德)|RD|(左|人民|除了|) Amr|如果|是|這次演講|負|完成|允許允許的話|在它|替代|賓格|後|例外，|就像:|(不|站在|人民|除了|紮伊德)|RD|(除外|紮伊德)|如果|是|這次演講|未完成|是|後|根據|功能/因素，|就像:|(不|站在|除了|紮伊德)|RD|(不|我擊中/擊/擊敗|除了|紮伊德)|RD|(不|我通過|除了|由紮伊德)。|我說:|知道|那|該名詞|發生|之後|(除外)|三|條件;|條件|第一:|有必要|賓格的|後|例外，|條件|第二:|可容許性|其下面的|為此，|之前|(除外)|後|它|替代|從它|含有|可容許性|其賓格|後|例外，|條件|第三:|必要性|其下面的|後|根據|什麼|要求|函數的|提到|之前|(除外)。|和解釋|，|那是|這次演講|其中|之前|(除外)|作為為|那|ㄧㄣ|完成|積極，|至於|那|ㄧㄣ|完成|消極，|至於|那|ㄧㄣ|未完成|而不是|ㄧㄣ|然後|除了|消極。|和意義|正在|這次演講|新的|完成:|那|提及|在它|除外|從它，|和意義|其被|未完成|那不|提及|在它|除外|從它，|和意義|正在|積極，|那不|它之前|否定|或|它的同類，|和類似|否定:|禁止，|並質疑/疑問句，|和意義|正在|消極，|那|它前面|一|這些|東西。|然後如果|是|這次演講|新的|完成|正|有必要|賓格|名詞的|發生|之後|(除外)|後|例外狀況|就像|你說:|(站在|人民|除了|紮伊德)|和你說:|(左|人民|除了|) Amr|然後紮伊|和 Amr:|兩個除外|從|語音|完成|為一提|除外|從它|-|它是|(人民)|於|第一; 首先|RD|(人民)|於|第二|-|這次演講|含有|那|是積極的|為缺乏的|來之前|否定|或|其類似;|在必要的時候|賓格的他們兩個，|與此|ㄧㄣ|條件|第一次。|如果|是|這次演講|新的|完成|負|這被允許的|在它|要遵循|後|補償與替換|或|賓格|後|例外，|就像|你說:|(不|站在|人民|除了|紮伊德)|然後紮伊德:|例外狀況|從|語音|完成|為被提及|除外|從它，|它是|人，|和演講|含有|那|否定|來之前|(不)|否定;|然後允許|在它|跟隨;|然後你說|(除外|紮伊德)|與主格;|因為|除外|從它|主格，|和替代|主格的|是主格，|並允許|在它|後|一點兒|賓格|後|例外;|然後你說:|(除外|紮伊德)|與此|ㄧㄣ|條件|第二次。|如果|是|這次演講|新的|不完整，|而不是|ㄧㄣ|除了|消極，|是|異常|後|根據|什麼|之前|(除外)|從|因素/原因/功能;|然後如果|是|功能|要求|主格|後|使用中的元素|它主格|在其上，|就像|(不|出席|除了|Ali)，|然後如果|是|功能|要求|賓格|後|物件/行事|其賓格的|在其上，|就像|(不|我看見|除了|阿裡)|如果|是|功能|要求|所有格|與粒子|從|顆粒/介詞|所有格的|其所有格|通過它，|就像:|(不|我通過|除了|由紮伊)|與此|ㄧㄣ|條件|第三個。|異常|與其他比|和它的姐妹|它說:|和異常|與/除以外，與不同的是，|除了 / 其他比/與不同的是，|除了 / 其他比/與不同的是，|和其他比|所有格|非|其他。|我說:|名詞|發生|之後|工具|從|這些|工具/顆粒|四|找到|其所有格|與附件/藏建設|工具|到它，|持續|工具|本身|然後當然它|需要|這項裁決|名詞的|發生|之後|(除外)|後|解釋/詳細資訊|其中|以前:|然後如果|是|這次演講|完成|正|其賓格|有必要|後|例外，|就像:|(站在|人民|除了|紮伊德)|如果|是|這次演講|完成|負|其以下|為此，|在它之前|或|其賓格|就像:|(不|拜訪了我|任何人|除了|高級/好)，|或:|(除外|高級/好)|如果|是|這次演講|未完成|負|它將進行|後|根據|功能: 起因，|就像|(不|連線|與其他比|高級/好)。|異常|與除分開從|和它的姐妹|它說:|和異常|與除分開從|除了分開從|除了分開從|它允許|其賓格|和它的所有格，|就像:|(站在|人民|除了|紮伊德，|與紮伊)|RD|(除外|Amr|和 Amr)，|RD|(除外|巴克爾|和巴克爾)。|我說:|名詞|發生|之後|工具|從|這些|顆粒|三|許可證|給你的|那|其賓格的情況下，|和許可證|給你的|那|其所有格|及原因|於|那|那是|這些|工具/工具|被用作|動詞|有時，|和使用|顆粒|有時|其他|後|什麼|之前，|然後如果|你表明它們是|動詞|賓格|什麼|之後他們|後|它|是物件/採取行動|通過它，|和表現的元素|代詞|隱藏|必要的義務，|如果|你表明它們是|顆粒|所有格|什麼|是在他們以後|後|它|是所有格|與他們。|和原因|這|頻繁的改變|在什麼|當|沒有|以前來過|在他們身上|(不)|不定式;|然後如果|來之前|後|一|從他們|(不)|是必不可少的|賓格|什麼|是在他們之後，|和原因|，|那是|(不)|不定式的|非|進入|除了|後|動詞;|然後他們|是動詞|在任何情況下|If|之前他們，|然後就像:|(站在|人民|除了|紮伊德)|許可證|在它|賓格|(紮)|和它的所有格，|和一樣:|(站在|人民|非|其他比|紮伊德)|非|允許|在它|除了|賓格|(紮)|和阿拉|光榮|被他|最高|而且他知道。|問題|對象|ㄧㄣ|例外情況|語言|和術語嗎?|對象|現在|工具/工具|例外?|進入|幾個|組件|劃分|工具/工具|例外?|幾個|條件|該名詞|發生|之後|除了嗎?|當|是必要的|賓格|名詞的|發生|之後|除了嗎?|當|許可證|賓格|名詞的|發生|之後|除了|及其追隨者|為此，|在他們面前是嗎?|對象|意思是|正在|這次演講|完成嗎?|對象|意思是|正在|這次演講|負面?|對象|是執政的|名詞的|發生|之後|其他比/除/不像嗎?|如何|是屈折|其他比/除/不像嗎?|對象|是執政的|名詞的|發生|之後|除了分開的嗎?|條件|運作的|(沒有)|功能|事實上當然|它說:|(第章|(沒有))|知道|那|(沒有)|讓賓格|無限期|與其他比|noonation|If|之間的自然數|無限期|也沒有|重複|(沒有)|就像|(沒有|人類|於|那所房子)。|我說:|知道|那|(沒有)|否定|萬能|運作|功能|(事實上當然可以)|然後使賓格|名詞|口述/運算式|或|代替的|和使主格|謂詞。|它是|非|運作|此|函式|重要|除了|四|條件:|第一; 首先|那|ㄧㄣ|其名詞|無限期。|第二種:|那|ㄧㄣ|其名詞|連接的|與它:|其中|其他比|分離|從它|如果|與謂詞。|和第三個:|那|ㄧㄣ|其名詞|無限期|也。|和第四個:|那不|重複|(沒有)。|接著|知道|那|名詞|(沒有)|後|三|類，|第一; 首先|奇異，|和第二個|連接藏有|到|無限期，|第三個|類似|與附加/擁有。|對於|單數|於|此|章，|中和|這一章|稱呼，|和是它:|(這其中|不是|附加/擁有|也不是|類似|與附加/擁有)|然後輸入|在它|雙，|和複數|破碎的|和複數|男子氣概|聲音，|和複數|女性氣質|聲音。|和其裁決|它|生成/是結構|後|什麼|讓賓格|由它:|然後當|是|其賓格|與罰的罵|它的結構|後|罰的罵，|就像:|(沒有|人類|於|首頁)，|如果|是|其賓格|與閻|-|和那|雙|和複數|男子氣概|聲音|-|結構|後|是啊|就像:|(沒有|兩個男人|於|房子)|和什麼時候|是|其賓格|與 kasra|更換|持續|罰的罵|-|和那|是複數|女性氣質|聲音|-|結構|後|kasra，|就像:|(有沒有|義人的婦女|今天)。|和|附加/擁有|於|賓格|與罰的罵|表觀|或|與那的|更換用代替|為它，|就像:|(沒有|學生|知識|最恨的)。|和|類似|-|附加/擁有|-|它是|(這其中|連接的|與它|事情|從|完成|它的意思)|然後示例|附加/擁有|於|裁決:|其中|讓賓格|與罰的罵，|就像:|(沒有|直線度/美譽/義|他的身體狀況的|其中|人民|是不喜歡)。|它說:|然後如果|沒有|後立即來|需要|主格|和需要|重複|(沒有)|就像:|(不|於|這房子|一個男人|也不是|一個女人)|然後如果|被重複|它是允許有|它的功能|以及它的撤銷，|然後如果|你想要|你說:|(沒有|人類|於|這房子|也不是|女人)|如果|你想要|你說:|(不|一個男人|於|這房子|也不是|一個女人)。|我說:|當然|你知道的|那|條件|重要|功能的|(沒有)|運作|(當然/的確)|四、|與此|討論|於|解釋|執政的|If|未實現|條件|從|條件|四|之間的自然數。|和指的|那|是它|If|發生|之後|(沒有)|是確定的|需要|取消|(沒有)|和它的重複，|就像|(不|默罕默德|拜訪了我|也不是|巴克爾)|如果|分離|介於|否|和它的名詞|分離|它，|重要|諸如此類|其取消|和其重複|就像|(沒有|在那裡|不好的影響|和沒有|他們|從它|將 intoxicated)(37:47)|然後壞的影響:|一門學科|延遲，|又在那裡:|有關|與刪除|謂詞的|來之前，|RD|(沒有)|否定|unpointed，|如果|重複|(沒有)|非|有必要|它的功能，|而是|允許許可證 /|它的功能|If|完成|剩下的|條件，|並允許許可證 /|其登出;|然後你說|後|功能|(沒有|人類|於|首頁|也不是|一個女人)|與罰的罵的|人類|和一個女人，|和你說|後|取消|(不|一個男人|於|首頁|也不是|一個女人)|與的主格|一個男人|和一個女人。|問題|對象|其中|讓|(沒有)|否定|為普遍性嗎?|對象|條件|需要|運作|(沒有)|否定|普遍性嗎?|進入|幾個|組件|劃分|名詞|不是嗎?|對象|是執政的|名詞的|(沒有)|奇異嗎?|對象|ㄧㄣ|單數|於|一章|(沒有)|和呼格嗎?|對象|是執政的|名詞的|(沒有)|If|是|附加/擁有|或|類似|與它嗎?|對象|是執政的|If|重複|(沒有)|否定?|對象|是執政的|If|發生|之後|(沒有)|否定之否定|是確定的嗎?|對象|是執政的|If|分離|介於|(沒有)|和它的名詞|分離嗎?
GreatMasterpiece70=呼格|它說:|(章|稱呼)|呼格|五|類型:|單數|專有名詞，|與不確定性|已知或意欲，|與不確定性|其他比|已知或意欲，|和附加/擁有，|和類似|與附加/擁有。|我說:|呼格|於|語言|它是:|要求/希望|它拉近距離|絕對，|中和|術語|語法學家的|它是|(要求/受通緝|它拉近距離|與 O|或|一|它的姐妹)|和的姐妹|(O)|他們是|五|就像|(O 紮伊|靠近)|RD|(O)|就像|(O|亞伯拉罕 ·|理解)|RD|(O)|就像:|O|樹木|Khabur|什麼是與你|美麗的綠色葉子|這是因為如果你是|非|傷心|持續|兒子|塔里夫的|RD|(O)|就像|(O|默罕默德|來吧)。|接著|呼格|後|五|種類:|1-|單數|專有名詞，|和肯定|過去式|於|一章|(沒有)|反映|奇異，|和它的例子|(穆罕默德)|RD|(O 法蒂瑪)|RD|(O 你兩個穆罕默德)|RD|(O 你兩個 Fatimas)|RD|(O 你所有穆罕默德)|RD|(O 你所有的 Fatimas)。|2-|無限期|目的是;|和它是:|其中|打算|與它|一|特定|與那的|是正確的|打來電話|由它的詞|在他身上，|就像|(O 不公正)|你想要|一|其具體。|3-|無限期|其他比|目的是;|和它是:|其中|打算|由它|一|其他比|具體，|就像|說|華納:|(O 疏忽的|注意到)|然後當然它|非|打算|一|具體，|而是|打算|每個|從|有關|在上面|表達|(疏忽的)。|4-|附加/擁有，|就像|(O 學生|知識|努力工作)。|5-|類似|與附加/擁有，|它是|這其中|高度重視|與它|事情|從|完成|它的意思，|是否|是|附件|與它|主格|有了它，|就像|(O 值得稱道|他的行動)|或|是|賓格|與它|就像|(O 儲存體和觀察員|對他的說教)|或|是|所有格|用粒子/介詞|所有格的|有關|與它|就像|(哦，愛人者|好)。|它說:|然後為|單數|專有名詞，|與不確定性|目的|然後都是結構|後|damma|從|其他比|noonation，|就像|(O) Zaid|RD|(啊)|和三個|剩餘|賓格|否|其他。|我說:|If|是|呼格|單數|或|無限期|目的|然後當然它|是結構|後|什麼|使它主格|與它;|然後如果|是|由主格|與 damma|然後當然它|是結構|後|damma，|就像|(穆罕默德)|RD|(O 法蒂瑪)|RD|(啊)|RD|(O 你所有 Fatimas)|如果|是|由主格|alef|更換|持續|damma|-|和那|是的對偶|-|然後當然它|是結構|後|阿勒夫|就像|(O 你兩個穆罕默德)|RD|(O 你兩個 Fatimas)|如果|是|由主格|帶有 waw|更換|持續|damma|-|和那|是複數形式|男子氣概|聲音|-|然後當然它|是結構|後|waw|就像|(O 你所有穆罕默德)。|如果|是|呼格|無限期|其他比|目的|或|附加/擁有|或|類似|與附加/擁有|然後當然它|讓賓格|與罰的罵|或|什麼|替換/替代品|為它|就像|(O 無知的人|學習)|RD|(O 懶人|是感興趣的轉機|後|這其中|對你有好處)|就像|(O desirer|榮譽|工作|為它)|RD|(哦，愛人者|高級狀態|堅持下去|後|努力)|就像|(O desirer|於|電源/規則|不要|生氣|從|工作)|RD|(O 是渴望的人|後|好|踏踏實實)。|問題|對象|ㄧㄣ|呼格|詞法上|和術語嗎?|對象|ㄧㄣ|工具|電話嗎?|車廠|為每個|工具/工具|結合實例，|into|幾個|組件|劃分|呼格嗎?|對象|ㄧㄣ|單數|和使|為它|兩個例子|不同，|什麼|ㄧㄣ|無限期|目的|含有|標記法?|對象|ㄧㄣ|類似|與附加/擁有嗎?|進入|幾個|種類|是分裂|類似|與附加/擁有|含有|標記法|為每個|類型是什麼?|對象|是執政的|呼格的|奇異嗎?|對象|是執政的|呼格的|附加/擁有嗎?|車廠|為每個|種類|從|種類|呼格的|五|用兩個例子，|和活用|一|從兩個。
GreatMasterpiece71=物件/行事|為本身|它說:|(章|物件/行事|從|其緣故/原因)|和它是:|名詞，|賓格|提及|解釋|原因|發生|行動，|就像|你說:|(站在|紮伊德|出於尊重|為 Amr)|RD|(我來找你|渴望|那對你有好處)。|我說:|物件/行事|從|其緣故/原因)|-|它是說|(物件/行事|它的緣故/理由)，|RD|(物件/行事|為本身)|-|它是|於|術語|語法學家的|短語|從|(名詞，|賓格|其中|提及|解釋|原因|發生|行動)。|和我們說:|(名詞)|包括|清除|和解釋|由它。|並且必須|於|名詞|其中|發生|物件/採取行動|為它|從|那|包括|在它|五|事情:|第一:|那|ㄧㄣ|動詞不定式。|和第二個:|那|ㄧㄣ|改變，|和意義|其被|多變|那不|ㄧㄣ|引用|後|一個函數|從|動作|物理/的四肢|像的手|和舌頭|示例|(閱讀)|RD|(打)。|和第三個:|那|ㄧㄣ|原因|為什麼|是在它之前。|和第四個:|那|ㄧㄣ|同意|含有|它的功能/它的影響|於|時間。|和第五個:|那|同意|含有|它的功能/它的影響|於|活躍的元素。|和示例|名詞的|包含|為這些|條件|(對學科)|從|你說:|(我打|我的兒子|對學科)|然後當然它|是不定式|它是|多變;|因為它|不是|從|動作|物理/的肢體，|它是|原因|為擊中，|和它|同意|含有|(打)|於|時間，|中和|活動元素|也。|和每個|名詞|實現|這些|條件|允許許可證 /|在它|兩件事:|賓格|和所有格|與粒子|從|顆粒/介詞|所有格的|引用|後|原因|像林。|知道|那|該名詞|其中|發生|物件/採取行動|為成因的緣故|三|條件:|第一:|那|ㄧㄣ|連接的|與。|第二種:|那|ㄧㄣ|附加所擁有。|第三:|那|ㄧㄣ|空閒|從|() / 明確的粒子|和從|擁有/附件建設。|中和|全部|這些|條件|允許/許可證|在它|賓格|和所有格|與粒子/介詞|所有格，|除了|它|可能|喜好設定|一|兩種方式，|和的可能|這兩個是平等|於|允許的職權範圍。|然後如果|是|連接的|與|然後主要是|在它|那|是由所有格|引用|後|究其原因，|就像:|(我打|我的兒子|為紀律)|很少會|其賓格。|如果|是|附加/擁有|准許禁止|其可容許性|同樣|那|其製作的所有格|用粒子/介詞|如果|是賓格|就像:|(我來看你|不愛|你良好的禮儀)|或|(我來看你|為愛|你良好的禮儀)。|如果|是|空閒|從|() / 明確的粒子|和從|附件/藏建設|然後主要是|在它|那|它使賓格，|就像:|(我站|出於尊重|為老師)|和很少|其所有格|用粒子/介詞，|和阿拉|知道。|問題|對象|ㄧㄣ|物件/行事|它的緣故/理由嗎?|對象|其中|要求|於|名詞|其中|發生|物件/採取行動|它的緣故/理由嗎?|幾個|條件|該名詞|發生|物件/採取行動|為本身?|對象|是執政的|物件/行事|為本身|已連結|與|和附加/擁有嗎?|車廠|三|範例|為物件/行事|為成因的緣故|與條件|那|ㄧㄣ|第一; 首先|已連結|與|和第二個|附加/擁有|第三個|空閒|從|的|與附件/藏建設|和活用|每個|一|從他們，|並引用|於|每個|示例|這其中|允許/許可證|在它|從|方式|含有|引用|最有可能|If|是的。
GreatMasterpiece72=物件/行事|與它 / 伴奏|它說:|(章|物件/行事|與它 / 伴奏)|和它是:|名詞，|賓格的情況下，|其中|被提及|與指定|從|誰是做對|與它|行動，|就像|你說:|(來了|領袖|與軍隊)|RD|(成為水準|水|用木頭)。|我說:|物件/行事|與它 / 伴奏|含有|語法學家|is:|(名詞，|附加/額外，|賓格|與動詞|或|什麼|在它|意義|動詞的|和它的字母，|引用|後|人/擁有者|其中|發生會發生|操作的動詞|其伴奏|之前|由 waw|用作|在一起/公司/與|在語言中)。|然後我們說:|(名詞)|包括|單數|和雙|和複數，|陽性|和女性|和解釋|與它:|名詞|清晰|沒有|解釋，|並考慮|從它|動詞|和顆粒|和這句話。|和我們說:|(額外/其他)|它的意思|它|不是|一個支柱|於|演講;|那麼就不是|活躍的元素，|而不是|一門學科|而不是|謂詞|取出|與它|支援/主要問題，|就像|(共用|宰|與 Amr)。|和我們說:|(賓格|與動詞|或|什麼|在它|意義|動詞的|和它的字母)|引用|後|那|病原體|於|物件/行事|與它 / 伴奏|後|兩種:|第一:|動詞，|就像|(在場|領袖|與軍隊)。|第二種:|名詞|引用|後|意義|動詞的|組成|後|它的字母，|像名詞/分詞|活動元素的|於|就像|(的領導|存在|與軍隊)。|和我們說:|(前面|由 waw|ㄧㄣ|在措辭中使用|於|引用|後|在一起/公司/與)|起飛|由它|名詞|之前|由 waw|非|在措辭|於|引用|後|伴奏，|就像|(出席|默罕默德|和哈立德)。|知道|那|名詞|發生|之後|waw|後|兩種:|1-|這其中|指定|其賓格|後|它|是/物件採取行動|與它 / 伴奏。|2-|其中|允許/許可證|其賓格|後|那|並且跟隨它|為此，|在它之前|於|其拐點/詞形變化|皮帶機|在上面。|和|那種|第一個|然後是它的地方|If|非|正確|要關聯|這其中|之後|waw|到那的|在它之前是|於|這項裁決，|就像|(我是|移動/旅行|與山)|就像|(I 研究和訂正|帶燈)|然後當然|這座山|非|正確|要關聯|對發言者/第一人|於|旅遊，|和像那樣|那盞燈|非|正確|要關聯|對發言者/第一人|於|學習所修改，|和肯定|作|作者|為此|種類|它說:|(成為水準|水|用木頭)。|和|第二|然後是它的地方|If|正確|要關聯|這其中|之後|waw|為此，|在它之前|於|資訊裁決|就像|(出席|阿裡|和默罕默德)|然後當然它|允許許可證 /|賓格的|(穆罕默德)|後|它|物件/採取行動|與它 / 伴奏，|並允許許可證 /|它主格|後|它|是友情|後|(); Ali|因為|默罕默德|允許許可證 /|把它聯繫起來|含有|阿裡|於|考勤、|和肯定|作|作者|為此|種類|它說:|(來了|領袖|與軍隊)。|問題|對象|ㄧㄣ|物件/行事|與它 / 伴奏嗎?|對象|目的是|與名詞|在這裡嗎?|對象|目的是|額外/額外嗎?|對象|其中|行為|於|物件/行事|與它 / 伴奏嗎?|進入|幾個|組件|劃分|物件/行事|與它 / 伴奏嗎?|車廠|為物件/行事|與它 / 伴奏|其中|是發現|它主格|用兩個例子，|成為|為物件/行事|與它 / 伴奏|其中|允許許可證 /|其賓格|並且跟隨它|為此，|在它之前是|用兩個例子，|活用|兩個例子|有哪些|於|這次演講|作者，|與指定|於|每個|示例|從這兩個|從|其中|種類|它是。|它說:|和|謂詞的|(是) / 動詞是|和它的姐妹|和的名詞|(當然/的確) / 賓格粒子|和它的姐妹|然後當然|來之前|提到的兩個|於|nominatives，|和像那樣|追隨者;|當然|來之前|那裡。|我說:|從|接動名詞做賓語|名詞|(當然/的確) / 賓格粒子|和它的姐妹，|和的謂詞|(是) / 動詞是|和它的姐妹，|和從動件|賓格的|和肯定|來之前|解釋|那|於|它的章節;|所以不|需要|對我們來說|到|重複|任何檔案|從它。
GreatMasterpiece73=屬格結構|從|名詞|它說:|(章|屬格結構的|從|名詞)|屬格結構|有三個|種類:|所有格|與粒子介詞|和所有格|與附件/藏建設，|和追隨者|所有格。|我說:|名詞|所有格的|後|三|種類;|和那|是的因為|所有格|為它|作為為|那|ㄧㄣ|一個粒子/介詞，|從|顆粒/介詞|所有格的|其中|之前|它的解釋，|於|第一; 首先|這本書的|而|會提到它|作者|之後|那，|和那|就像|() Khalid|從|你說:|(我的情分慈悲 /|後|哈立德)|然後當然它|是所有格|通過後，|它是|一個粒子/介詞|從|顆粒/介詞|所有格，|和|那|ㄧㄣ|所有格|該名詞|附件/藏建設|一個名詞|在它之前|到它，|和意義|財產/附件建設:|連線|第二個|第一，|和那|就像|(穆罕默德)|從|你說:|(來了|僕人的男孩|默罕默德)|然後當然它|是所有格|與原因 /|附件/藏建設的|(僕人或男孩)|到它，|和|那|ㄧㄣ|所有格|該名詞|其以下|為一個名詞|所有格，|與那|ㄧㄣ|形容詞|為它，|就像|(區分/學習)|從|你說:|(我用了|知識|從|默罕默德|尊敬/學會)|或|皮帶機|在其上，|就像|() Khalid|從|你說:|(我通過|由穆罕默德|和哈立德)|或|其他比|這兩個|從|追隨者|其中|之前|他們提到。
GreatMasterpiece74=它說:|和|所有格|與介詞/顆粒|然後是:|什麼|是由所有格|通過從，|和到/對，|和從，|及後，|和，|和一些/許多/也許，|和呸，|和 kaf，|和林|和之前的粒子的介詞|誓詞 》:，|和他們是:|waw|和呸，|和 tah，|或|帶有 waw|可能，|和與以來，|和自 / 前。|我說:|那種|第一個|從|屬格結構:|所有格|由介詞/粒子|從|介詞/顆粒|所有格;|和之前的介詞的粒子|所有格的|有很多。|從他們|(從)|從|它的意思|從開始，|它使所有格|名詞|表觀|和隱藏，|就像|它說:|最高:|(和從你|和從|Noah)(33:7)。|並且從他們|(對)|和從|它的意思|結局，|它使所有格|名詞|表觀|和隱藏|此外，|就像|它說:|最高:|(|給他|將傳給後人|知識|小時的|)(41:47)|和它說:|(到|真主|將返回的你|all)(5:48)。|並且從他們|(從)|和從|它的意思|過剩/超越，|它使所有格|名詞|表觀|和隱藏|此外，|就像|它說:|最高:|(|當然|很高興|真主|含有|believers)(48:18)|和它說:|(很高興|真主|與他們|他們感到高興|與他|)(5:119)。|並且從他們|(上)|和從|它的意思|以上/上，|它使所有格|名詞|表觀|和隱藏|此外，|就像|它說:|最高:|(和他們|和後|船舶|你是 carried)(23:22)。|並且從他們|(中)|和從|它的意思|狀語/容器，|它使所有格|名詞|表觀|隱藏|此外，|就像|它說:|最高:|(和在|天空|是你 provision)(51:22)|和它說:|(不|其中|headache)(37:47)。|並且從他們|(一些/許多/也許)|和從|它的意思|減少/減少，|而不是|它使所有格|除了|名詞|表觀|無限期，|就像|你說:|(幾|男人|大方|我見過)。|並且從他們|(呸)|和從|它的意思|過剩/超越/逾越，|它使所有格|名詞|表觀|和代詞|所有的人，|就像|它說:|最高:|(是否|我們帶走|與 you)(43:41)|和它說:|(去|真主|與他們的 light)(2:17)。|並且從他們|() kaf|和從|它的意思|比較，|而不是|它使所有格|除了|名詞|很明顯，|就像|它說:|最高:|(比喻|他的光的|就像 niche)(24:35)。|並且從他們|(林)|和從|它的意思|老有所為|和擁有，|它使所有格|名詞|表觀|和隱藏|此外，|就像|它說:|光榮是他|和尊貴:|(美化|向安拉|什麼|在其中|諸天|和地球|)(57:1)，|和它說:|(為他|自治領/王國/擁有權|諸天的國|和地球|)(2:107)。|並且從他們|顆粒|誓言|三|-|和他們是:|呸，|和 tah，|和 waw|-|和肯定|我們說話|在他們身上|這次演講|詳細|於|第一; 首先|書;|然後不|需要|對我們來說|到|重複|任何檔案|從它。|並且從他們|waw 的|(一些/許多/也許)|和它的例子|說|Imree'|卡伊斯|很多個夜晚|是像波浪一樣在悲傷中|海/深|它可以讓下: 降低|其面紗窗簾|他說:|此外:|和許多美麗/貞潔/可敬|婦女的|不要|離開|家裡的帳篷|並且從他們|(以來)|RD|自 (前)|和兩個使所有格|兩次，|和兩個|該值指示|後|含義|(從)|If|是|這其中|後兩個|過去時態，|就像|(不|我看見他|自|這一天|星期四的五次)，|RD|(不|並和他在說話|持續|一個月)，|兩個是|與意義|(中)|If|是|這其中|是在他們兩個以後|現在時態|就像|(不|我講給他|持續|今天)|RD|(不|我確實見過|在期間|今天一天)。|然後如果|發生|之後|(自/在/為)|或|(自/在/為)|一個動詞，|或|是|名詞|其中|在它以後|主格|然後這兩個|是名詞。
GreatMasterpiece75=它說:|和|這其中|使得所有格|與附件/藏建設，|然後就像|你說:|(男孩和僕人|紮伊德) 的|它是|後|兩個部分:|這其中|被暗示|與林，|和什麼|被暗示|與從;|和那個的|被暗示|與林|就像|(男孩和僕人|紮伊德) 的|和那個的|被暗示|與從，|就像|(服裝|絲綢)|RD|(一扇門|鐵片)|RD|(環|鐵)。|我說:|第部分|第二個|從|屬格結構:|所有格|隨著擁有/附件建設，|它是|後|三|類，|提到|作者|從他們|兩種;|第一:|這其中|ㄧㄣ|與附件/藏建設|在它|後|意義|(從)|和第二個:|這其中|ㄧㄣ|附件/藏建設|在它|後|意義|之林，|和第三個:|這其中|ㄧㄣ|附件/藏建設|在它|後|意義|(在)。|和|這其中|ㄧㄣ|附件/藏建設|在它|後|意義|(從)|然後是它的一般規則:|那|ㄧㄣ|附加/擁有|部分|和一些|從|附加/擁有|到它，|就像|(長服裝|羊毛)|然後當然|長服裝|部分|羊毛的|和部分|從它，|和像那樣|該示例|作者。|和|這其中|ㄧㄣ|附件/藏建設|在它|後|意義|(中)|然後是它的一般規則:|那|ㄧㄣ|附加/擁有|到它|副詞|為附加/擁有，|就像|它說:|最高:|(而是|密謀|在 night)(34:33)|然後當然|晚上|是個副詞，|過夜|和時間|發生|密謀|在它。|和|這其中|ㄧㄣ|附件/藏建設|在它|後|意義|之林;|然後每個|這其中|不是|正確|在它|一|兩種|所提到，|就像|(男孩和僕人|默罕默德)|RD|(在墊子上|在清真寺)。|肯定|排除在外|作者|這次演講|後|第部分|第三個|從|屬格結構，|它是|所有格|與追隨者們，|和他的藉口|於|那|是他|當然|以前|說|在上面|於|最後一次|各章|nominatives|詳細|和阿拉|光榮是他|和崇高|最高|他知道|讚美|和是慷慨。|問題|後|幾個|種類|被劃分|屬格結構嗎?|對象|意思是|其中|指示|在上面|粒子:|從|關於，|在中，|幾個/很多/也許，|kaf，|林?|和什麼|其中|它使所有格|每個|一|從他們嗎?|車廠|兩個例子|從|你的創造|該名詞|所有格的|與每個|一|從|顆粒/介詞:|後，|呸，|對，|waw|誓言。|後|幾個|種類|來自|附件/藏建設嗎?|根據|範例|為每個|種類|兩個例子。|對象|是的一般規則|附件/藏建設的|其中|後|意義|(從) 嗎?|根據|例子。|對象|是的一般規則|附件/藏建設的|其中|後|意義|(中) 嗎?|根據|例子。
Maxim1=行動/事蹟|取決於與他們的意圖
Maxim2=確實性|不是|失效/否決|由疑問
Maxim3=困難/困難|生帶來了|設施/易用性
Maxim4=危害|必須消除|(沒有|應造成傷害|也不是|應得到回報的傷害)
Maxim5=自訂|確定/可作為判斷的基礎
Maxim6=給出了影響/值|對詞，語句語音|是更好、 更適當的/優先比|忽略/忽略他們
MaximComp1=當|刪除/不再存在|防噴器|傳回|防止
MaximComp2=對象|被允許的|因為一個原因/理由|是廢止會失效|與它的去除/一次它不存在
MaximComp3=當|衝突|防噴器/萬向|和需要|應獲優先考慮|預防/萬向
MaximComp4=對象|被禁止|採取它|被禁止|給它
MaximComp5=對象|被禁止|要使用它|被禁止|保持它
MaximComp6=對象|被禁止|要做它|被禁止|以需求/請求它
MaximFollow1=從動件|如下
MaximFollow2=附件|非|可以/應該分離/獨立|從判決
MaximFollow3=誰|擁有|東西|擁有|這其中|ㄧㄣ|從的|其必需的元件
MaximFollow4=赦免被忽視|於|從動件/附件|這其中|非|可以赦免被忽視|這件事被跟隨/附加
MaximFollow5=從動件|非|將去前方/得到優先/之前|後|被跟蹤的事情
MaximFollow6=If|取消變得空虛|正在跟隨/附加的東西|取消變得空虛|附件/追隨者|或|附件/追隨者|變得無效|與無效|正在連接後跟的事
MaximRootDeriv1=當|無效|本起源|應無效|導數/分支機搆
MaximRootDeriv2=當|是不正確|東西|即屬無效|這其中|於|它的裡面
MaximRootDeriv3=什麼被放棄|非|能恢復|就好像|那|根本不存在|非|可以恢復
MaximRootDeriv4=五月|有效期|導數|沒有|根
MaximRootDeriv5=當|便會作廢|根|變得尋求|到|替代
MaximLiability1=產量/利潤/土地/稅|有 / 伴隨著責任損失/補償/保證/責任
MaximLiability2=損失的損失風險|與 / 伴隨獲利
MaximLiability3=輪到青睞|是按比例|壞的輪/不幸/逆境|和壞的輪/不幸/逆境|是按比例|輪到青睞
MaximLiability4=付租金|和賠償責任|非|將合併可以一起去/可能具有包容性
MaximLiability5=允許/許可權|宗教/法律|不包括勾銷|賠償責任
MaximLiability6=基本原則|於|補償|那是|補償|喜歡/同一件事|與它象|和有價值的東西|與它的價格
MaximLiability7=行為人/遺囑執行人/人的行為|一經定罪，以彌補由此而造成的任何損失|即使|非|他想嗎
MaximLiability8=當|收集/禮物|直接執行者/犯罪行為人的行為|和是事業的人|連結/實施|這項裁決|到|直接執行者/犯罪行為人的行為
MaximLiability9=致事/人是行為的原因|非|將補償/法律責任作出好造成的任何損失|除非|意圖
MaximLiability10=損傷/犯罪|動物的|不是責任/浪費
MaximProperty1=Not|它被允許|為任何人|那|處置|於|該屬性|另一個|沒有|在擁有者同意的
MaximProperty2=叮囑/告訴|處理/做處置|於|該屬性|別人的|無效無效
MaximProperty3=Not|它被允許|為任何人|那|需要|財富，財產|任何人|沒有|原因|法務
MaximProperty4=誰|在別人面前擁有|到|不允許|然後當然|他將會擁有它
MaximProperty5=在更改|原因|擁有權的一件事|需要|位置/地點|正在變更|那件事本身
MaximCondition1=什麼是依賴|上一個條件|必須為|完成|一次，當|被實現|條件
MaximCondition2=應綁定|整合|到一個條件|很遠的地方作為|可能
MaximCondition3=協定或承諾|中的形狀|條件/條件家屬|是強制的
MaximCondition4=件事|當|很嚴重 /|它的位置|被視為嚴重考慮重要性|在它|增加|其條件
MaximCondition5=對象|已建立|由伊斯蘭法律|是優先考慮/優先|過度|什麼|已建立|由條件
MaximCondition6=每|條件|沒有這種與相反|這項裁決|伊斯蘭法|是不正確
MaximOther1=簡單的事|非|應放棄|由 / 困難的事情
MaximOther2=誰/什麼是心事重重忙著一份工作|非|能與另一個忙
MaximOther3=連續性|更容易|於|生效日期
MaximOther4=事情應能被赦免|於|連續性|什麼|非|可以赦免|於|生效日期生效日期 / 時間
MaximOther5=預防|更容易|於|取消或廢除/取消/取消
MaximOther6=處置|在|人/從屬儲存格的屬性|是依賴于特遣隊、|所得利息
MaximOther7=什麼被建立|由一個證明|是那樣的建立|通過查看
MaximOther8=一個人|綁定|由供狀入場|/|坦白|一個人的|關於反對|他自己|被接受
MaximOther9=證據|證明|足夠|和入場|證明|對別人的不足
MaximOther10=沒有 / 勾銷|有力的證據|含有|矛盾|但|非|使無效得到無效|與它|判斷|一名法官 / 已經已通過
MaximOther11=未知|於|伊斯蘭法|作為 / 當作不存在|和不可能的事|在 it/到知道
MaximOther12=將歸因|動作|到|演員/實幹家|非|吩咐的人|這其中|非|是|強迫
MaximOther13=Not|將完成|捐贈|除了直到|與收到收據 /
MaximOther14=不具有|播種機/樹/樹的分支|不公正|一項權利
MaximOther15=對象|接近于|原創的東西|將給出|其執政
MaximOther16=什麼嗎|非|並得到應驗|義務|除了 / 除非|通過與它|ㄧㄣ|義務
MaximOther17=否|俱樂部|對於硬派生工作/法律裁決/個體，獨立的判斷，基於理性的推理|在哪兒|那裡是|決定性的文本
MaximOther18=努力工作/派生法律裁決/個人，基於理性推理的獨立判斷|非|可以失效|由其類似 / 相同
